{
    "name": "Community Centre",
    "raw": "░░░░░░░░░░░░░░░░░░░░░░░░░░░░░░░░░░░░░░░░░░░░░░░░░░░░░░░░░░░░░░░░░░░░░░░░░░░░░░░░░░░░░░░░░░░░░░░░░░░░░░░░░░░░░░░░░░░░░░░░░░░░░░░░░░░░░░░░░░░░░░░░░░░░░░░░░░░░▉▉▉▉▉▉▉▉▉▉▉▉▉▉▉▉▉▉▉▉▉▉▉▉▉▉▉▉▉▉░░░░░░░░░░░░░░
░░░░░░░░░░░░░░░░░░░░░░░░░░░░░░░░░░░░░░░░░░░░░░░░░░░░░░░░░░░░░░░░░░░░░░░░░░░░░░░░░░░░░░░░░░░░░░░░░░░░░░░░░░░░░░░░░░░░░░░░░░░░░░░░░░░░░░░░░░░░░░░░░░░░░░░░░░░░                              ░░░░░░░░░░░░░░
░░░░░░░░░░░░░░░░░░░░░░░░░░░░░░░░░░░░░░░░░░░░░░░░░░░░░░░░░░░░░░░░░░░░░░░░░░░░░░░░░░░░░░░░░░░░░░░░░░░░░░░░░░░░░░░░░░░░░░░░░░░░░░░░░░░░░░░░░░░░░░░░░░░░░░░░░░░░                              ░░░░░░░░░░░░░░
░░░░░░░░░░░░░░░░░░░░░░░░░░░░░░░░░░░░░░░░░░░░░░░░░░░░░░░░░░░░░░░░░░░░░░░░░░░░░░░░░░░░░░░░░░░░▉▉▉▉▉▉▉▉▉▉░░░░░░░░░░░░░░░░░░░░░░░░░░░░░░░░░░░░░░░░░░░░░░░░░░░░░░                              ░░░░░░░░░░░░░░
░░░░░░░░░░░░░░░░░░░░░░░░░░░░░░░░░░░░░░░░░░░░░░░░░░░░░░░░░░░░░░░░░░░░░░░░░░░░░░░░░░░░░░░░▉▉▉▉▉▉▉▉▉▉▉▉▉▉▉▉▉▉░░░░░░░░░░░░░░░░░░░░░░░░░░░░░░░░░░░░░░░░░░░░░░░░░░                              ░░░░░░░░░░░░░░
░░░░░░░░░░░░░░░░░░░░░░░░░░░░░░░░░░░░░░░░░░░░░░░░░░░░░░░░░░░░░░░░░░░░░░░░░░░░░░░░░░░░░░▉▉▉▉▉▉▉▉▉▉▉▉▉▉▉▉▉▉▉▉▉▉░░░░░░░░░░░░░░░░░░░░░░░░░░░░░░░░░░░░░░░░░░░░░░░░                              ░░░░░░░░░░░░░░
░░░░░░░░░░░░░░░░░░░░░░░░░░░░░░░░░░░░░░░░░░░░░░░░░░░░░░░░░░▉▉▉▉▉▉▉▉▉▉▉▉▉▉▉▉▉▉▉▉▉▉▉▉▉▉▉▉▉▉▉▉▉▉▉▉▉▉▉▉▉▉▉▉▉▉▉▉▉▉▉▉▉▉▉▉▉▉▉▉▉▉▉▉▉▉▉▉▉▉▉▉▉▉░░░░░░░░░░░░░░░░░░░░░░░░                              ░░░░░░░░░░░░░░
░░░░░░░░░░░░░░░░░░░░░░░░░░░░░░░░░░░░░░░░░░░░░░░░░░░░░░░░░░▉▉▉▉▉▉▉▉▉▉▉▉▉▉▉▉▉▉▉▉▉▉▉▉▉▉▉▉▉▉▉▉▉▉▉▉▉▉▉▉▉▉▉▉▉▉▉▉▉▉▉▉▉▉▉▉▉▉▉▉▉▉▉▉▉▉▉▉▉▉▉▉▉▉░░░░░░░░░░░░░░░░░░░░░░░░                              ░░░░░░░░░░░░░░
░░░░░░░░░░░░░░░░░░░░░░░░░░░░░░░░░░░░░░░░░░░░░░░░░░░░░░░░░░▉▉▉▉▉▉▉▉▉▉▉▉▉▉▉▉▉▉▉▉▉▉▉▉░░░░░░░░░░░░░░░░░░░░░░░░                              ░░░░░░░░░░░░░░
░░░░░░░░░░░░░░░░░░░░░░░░░░░░░░░░░░░░░░░░░░░░░░░░░░░░░░░░░░▉▉▉▉▉▉▉▉▉▉▉▉▉▉▉▉▉▉▉▉▉▉▉▉░░░░░░░░░░░░░░░░░░░░░░░░                              ░░░░░░░░░░░░░░
░░░░░░░░░░▉▉▉▉▉▉▉▉▉▉▉▉▉▉▉▉▉▉▉▉▉▉▉▉▉▉▉▉▉▉▉▉▉▉▉▉▉▉▉▉▉▉▉▉▉▉▉▉▉▉▉▉▉▉▉▉▉▉▉▉▉▉▉▉▉▉▉▉▉▉▉▉░░░░░░░░░░░░░░░░░░░░░░░░                              ░░░░░░░░░░░░░░
░░░░░░░░░░▉▉▉▉▉▉▉▉▉▉▉▉▉▉▉▉▉▉▉▉▉▉▉▉▉▉▉▉▉▉▉▉▉▉▉▉▉▉▉▉▉▉▉▉▉▉▉▉▉▉▉▉▉▉▉▉▉▉▉▉▉▉▉▉▉▉▉▉▉▉▉▉▉▉▉▉▉▉▉▉▉▉▉▉▉▉▉▉▉▉▉▉▉▉▉▉▉▉▉▉▉▉▉▉▉▉▉▉▉▉▉▉▉▉▉▉▉▉▉▉▉▉░░░░░░░░░░░░░░░░░░░░░░░░                              ░░░░░░░░░░░░░░
░░░░░░░░░░▉▉▉▉▉▉▉▉▉▉▉▉▉▉▉▉▉▉▉▉▉▉▉▉▉▉▉▉▉▉▉▉▉▉▉▉▉▉▉▉▉▉▉▉▉▉▉▉▉▉▉▉▉▉▉▉▉▉▉▉▉▉▉▉▉▉▉▉▉▉▉▉▉▉▉▉▉▉▉▉▉▉▉▉▉▉▉▉▉▉▉▉▉▉▉▉▉▉▉▉▉▉▉▉▉▉▉▉▉▉▉▉▉▉▉▉▉▉▉▉▉▉░░░░░░░░░░░░░░░░░░░░░░░░                              ░░░░░░░░░░░░░░
░░░░░░░░░░▉▉▉▉▉▉▉▉▉▉▉▉▉▉▉▉▉▉▉▉▉▉▉▉▉▉▉▉▉▉▉▉▉▉▉▉▉▉▉▉▉▉▉▉▉▉▉▉▉▉▉▉▉▉▉▉▉▉▉▉▉▉▉▉▉▉▉▉▉▉▉▉▉▉▉▉▉▉▉▉▉▉▉▉▉▉▉▉▉▉▉▉▉▉▉▉▉▉▉▉▉▉▉▉▉▉▉▉▉▉▉▉▉▉▉▉▉▉▉▉▉▉▉▉▉▉▉▉▉▉▉▉░░░░░░░░░░░░░░                              ░░░░░░░░░░░░░░
░░░░░░░░░░▉▉▉▉▉▉▉▉▉▉▓▓▓▓▓▓▓▓▓▓▓▓▓▓▓▓▓▓▓▓▓▓▓▓▓▓▓▓▓▓▓▓▓▓▓▓▓▓▓▓▓▓▓▓▓▓▓▓▓▓▓▓▓▓▉▉▉▉▉▉▉▉▉▉▉▉▉▉▉▉▉▉▉▉▉▉▉▉▉▉▓▓▓▓▓▓▓▓▓▓▓▓▓▓▓▓▓▓▓▓▓▓▓▓▓▓▓▓▓▓▉▉▉▉▉▉▉▉▉▉▉▉▉▉▉▉░░░░░░░░░░                              ░░░░░░░░░░░░░░
░░░░░░░░░░▉▉▉▉▉▉▉▉▉▉▓▓▓▓▓▓▓▓▓▓▓▓▓▓▓▓▓▓▓▓▓▓▓▓▓▓▓▓▓▓▓▓▓▓▓▓▓▓▓▓▓▓▓▓▓▓▓▓▓▓▓▓▓▓▉▉▉▉▉▉▉▉▉▉▉▉▉▉▉▉▉▉▉▉▉▉▉▉▉▉▓▓▓▓▓▓▓▓▓▓▓▓▓▓▓▓▓▓▓▓▓▓▓▓▓▓▓▓▓▓▉▉▉▉▉▉▉▉▉▉▉▉▉▉▉▉░░░░░░░░░░                              ░░░░░░░░░░░░░░
░░░░░░░░░░▉▉▉▉▉▉▉▉▉▉▓▓▓▓▓▓▓▓▓▓▓▓▓▓▓▓▓▓▓▓▓▓▓▓▓▓▓▓▓▓▓▓▓▓▓▓▓▓▓▓▓▓▓▓▓▓▓▓▓▓▓▓▓▓▉▉▉▉▉▉▉▉▉▉▉▉▉▉▉▉▉▉▉▉▉▉▉▉▉▉▓▓▓▓▓▓▓▓▓▓▓▓▓▓▓▓▓▓▓▓▓▓▓▓▓▓▓▓▓▓▉▉▉▉▉▉▉▉▉▉▉▉▉▉▉▉▉▉░░░░░░░░                              ░░░░░░░░░░░░░░
░░░░░░░░░░▉▉▉▉▉▉▉▉▉▉▓▓▓▓▓▓▓▓▓▓▓▓▓▓▓▓▓▓▓▓▓▓▓▓▓▓▓▓▓▓▓▓▓▓▓▓▓▓▓▓▓▓▓▓▓▓▓▓▓▓▓▓▓▓▉▉▉▉▉▉▉▉▉▉▉▉▉▉▉▉▉▉▉▉▉▉▉▉▉▉▓▓▓▓▓▓▓▓▓▓▓▓▓▓▓▓▓▓▓▓▓▓▓▓▓▓▓▓▓▓▉▉▉▉▉▉▉▉▉▉▉▉▉▉▉▉▉▉▉▉░░░░░░                              ░░░░░░░░░░░░░░
░░░░░░░░░░▉▉▉▉▉▉▉▉▉▉▓▓▓▓▓▓▓▓▓▓▓▓▓▓▓▓▓▓▓▓▓▓▓▓▓▓▓▓▓▓▓▓▓▓▓▓▓▓▓▓▓▓▓▓▓▓▓▓▓▓▓▓▓▓▉▉▉▉▉▉▉▉▉▉▉▉▉▉▉▉▉▉▉▉▉▉▉▉▉▉▓▓▓▓▓▓▓▓▓▓▓▓▓▓▓▓▓▓▓▓▓▓▓▓▓▓▓▓▓▓▉▉▉▉▉▉▉▉▉▉▉▉▉▉▉▉▉▉▉▉░░░░░░                              ░░░░░░░░░░░░░░
░░░░░░░░░░▉▉▉▉▉▉▉▉▉▉▓▓▓▓▓▓▓▓▓▓▓▓▓▓▓▓▓▓▓▓▓▓▓▓▓▓▓▓▓▓▓▓▓▓▓▓▓▓▓▓▓▓▓▓▓▓▓▓▓▓▓▓▓▓▉▉▉▉▉▉▉▉▉▉▉▉▉▉▉▉▉▉▉▉▉▉▉▉▉▉▓▓▓▓▓▓▓▓▓▓▓▓▓▓▓▓▓▓▓▓▓▓▓▓▓▓▓▓▓▓▉▉▉▉▉▉▉▉▉▉▉▉▉▉▉▉▉▉▉▉▉▉░░░░                              ░░░░░░░░░░░░░░
░░░░░░░░░░▉▉▉▉▉▉▉▉▉▉▓▓▓▓▓▓▓▓▓▓▓▓▓▓▓▓▓▓▓▓▓▓▓▓▓▓▓▓▓▓▓▓▓▓▓▓▓▓▓▓▓▓▓▓▓▓▓▓▓▓▓▓▓▓▉▉▉▉▉▉▉▉▉▉▉▉▉▉▉▉▉▉▉▉▉▉▉▉▉▉▓▓▓▓▓▓▓▓▓▓▓▓▓▓▓▓▓▓▓▓▓▓▓▓▓▓▓▓▓▓▉▉▉▉▉▉▉▉▉▉▉▉▉▉▉▉▉▉▉▉▉▉░░░░                              ░░░░░░░░░░░░░░
░░░░░░░░░░▉▉▉▉▉▉▉▉▉▉▓▓▓▓▓▓▓▓▓▓▓▓▓▓▓▓▓▓▓▓▓▓▓▓▓▓▓▓▓▓▓▓▓▓▓▓▓▓▓▓▓▓▓▓▓▓▓▓▓▓▓▓▓▓▉▉▉▉▉▉▉▉▉▉▉▉▉▉▉▉▉▉▉▉▉▉▉▉▉▉▓▓▓▓▓▓▓▓▓▓▓▓▓▓▓▓▓▓▓▓▓▓▓▓▓▓▓▓▓▓▉▉▉▉▉▉▉▉▉▉▉▉▉▉▉▉▉▉▉▉▉▉░░░░                              ░░░░░░░░░░░░░░
░░░░░░░░░░▉▉▉▉▉▉▉▉▉▉▓▓▓▓▓▓▓▓▓▓▓▓▓▓▓▓▓▓▓▓▓▓▓▓▓▓▓▓▓▓▓▓▓▓▓▓▓▓▓▓▓▓▓▓▓▓▓▓▓▓▓▓▓▓▉▉▉▉▉▉▉▉▉▉▉▉▉▉▉▉▉▉▉▉▉▉▉▉▉▉▓▓▓▓▓▓▓▓▓▓▓▓▓▓▓▓▓▓▓▓▓▓▓▓▓▓▓▓▓▓▉▉▉▉▉▉▉▉▉▉▉▉▉▉▉▉▉▉▉▉▉▉░░░░                              ░░░░░░░░░░░░░░
░░░░░░░░░░▉▉▉▉▉▉▉▉▉▉▓▓▓▓▓▓▓▓▓▓▓▓▓▓▓▓▓▓▓▓▓▓▓▓▓▓▓▓▓▓▓▓▓▓▓▓▓▓▓▓▓▓▓▓▓▓▓▓▓▓▓▓▓▓▉▉▉▉▉▉▉▉▉▉▉▉▉▉▉▉▉▉▉▉▉▉▉▉▉▉▓▓▓▓▓▓▓▓▓▓▓▓▓▓▓▓▓▓▓▓▓▓▓▓▓▓▓▓▓▓▉▉▉▉▉▉▉▉▉▉▉▉▉▉▉▉▉▉▉▉▉▉░░░░                              ░░░░░░░░░░░░░░
░░░░░░░░░░▉▉▉▉▉▉▉▉▉▉▓▓▓▓▓▓▓▓▓▓▓▓▓▓▓▓▓▓▓▓▓▓▓▓▓▓▓▓▓▓▓▓▓▓▓▓▓▓▓▓▓▓▓▓▓▓▓▓▓▓▓▓▓▓▉▉▉▉▉▉▉▉▉▉▉▉▉▉▉▉▉▉▉▉▉▉▉▉▉▉▓▓▓▓▓▓▓▓▓▓▓▓▓▓▓▓▓▓▓▓▓▓▓▓▓▓▓▓▓▓▉▉▉▉▉▉▉▉▉▉▉▉▉▉▉▉▉▉▉▉▉▉░░░░                              ░░░░░░░░░░░░░░
░░░░░░░░░░▉▉▉▉▉▉▉▉▉▉▓▓▓▓▓▓▓▓▓▓▓▓▓▓▓▓▓▓▓▓▓▓▓▓▓▓▓▓▓▓▓▓▓▓▓▓▓▓▓▓▓▓▓▓▓▓▓▓▓▓▓▓▓▓▉▉▉▉▉▉▉▉▉▉▉▉▉▉▉▉▉▉▉▉▉▉▉▉▉▉▓▓▓▓▓▓▓▓▓▓▓▓▓▓▓▓▓▓▓▓▓▓▓▓▓▓▓▓▓▓▉▉▉▉▉▉▉▉▉▉▉▉▉▉▉▉▉▉▉▉▉▉░░░░                              ░░░░░░░░░░░░░░
░░░░░░░░░░▉▉▉▉▉▉▉▉▉▉▓▓▓▓▓▓▓▓▓▓▓▓▓▓▓▓▓▓▓▓▓▓▓▓▓▓▓▓▓▓▓▓▓▓▓▓▓▓▓▓▓▓▓▓▓▓▓▓▓▓▓▓▓▓▉▉▉▉▉▉▉▉▉▉▉▉▉▉▉▉▉▉▉▉▉▉▉▉▉▉▓▓▓▓▓▓▓▓▓▓▓▓▓▓▓▓▓▓▓▓▓▓▓▓▓▓▓▓▓▓▉▉▉▉▉▉▉▉▉▉▉▉▉▉▉▉▉▉▉▉▉▉░░░░                              ░░░░░░░░░░░░░░
░░░░░░░░░░▉▉▉▉▉▉▉▉▉▉▓▓▓▓▓▓▓▓▓▓▓▓▓▓▓▓▓▓▓▓▓▓▓▓▓▓▓▓▓▓▓▓▓▓▓▓▓▓▓▓▓▓▓▓▓▓▓▓▓▓▓▓▓▓▉▉▉▉▉▉▉▉▉▉▉▉▉▉▉▉▉▉▉▉▉▉▉▉▉▉▓▓▓▓▓▓▓▓▓▓▓▓▓▓▓▓▓▓▓▓▓▓▓▓▓▓▓▓▓▓▉▉▉▉▉▉▉▉▉▉▉▉▉▉▉▉▉▉▉▉░░░░░░                              ░░░░░░░░░░░░░░
░░░░░░░░░░▉▉▉▉▉▉▉▉▉▉▓▓▓▓▓▓▓▓▓▓▓▓▓▓▓▓▓▓▓▓▓▓▓▓▓▓▓▓▓▓▓▓▓▓▓▓▓▓▓▓▓▓▓▓▓▓▓▓▓▓▓▓▓▓▉▉▉▉▉▉▉▉▉▉▉▉▉▉▉▉▉▉▉▉▉▉▉▉▉▉▓▓▓▓▓▓▓▓▓▓▓▓▓▓▓▓▓▓▓▓▓▓▓▓▓▓▓▓▓▓▉▉▉▉▉▉▉▉▉▉▉▉▉▉▉▉▉▉▉▉░░░░░░                              ░░░░░░░░░░░░░░
░░░░░░░░░░▉▉▉▉▉▉▉▉▉▉▓▓▓▓▓▓▓▓▓▓▓▓▓▓▓▓▓▓▓▓▓▓▓▓▓▓▓▓▓▓▓▓▓▓▓▓▓▓▓▓▓▓▓▓▓▓▓▓▓▓▓▓▓▓▉▉▉▉▉▉▉▉▉▉▉▉▉▉▉▉▉▉▉▉▉▉▉▉▉▉▓▓▓▓▓▓▓▓▓▓▓▓▓▓▓▓▓▓▓▓▓▓▓▓▓▓▓▓▓▓▉▉▉▉▉▉▉▉▉▉▉▉▉▉▉▉▉▉░░░░░░░░                              ░░░░░░░░░░░░░░
░░░░░░░░░░▉▉▉▉▉▉▉▉▉▉▉▉▉▉▉▉▉▉▉▉▉▉▉▉▉▉▉▉▉▉▉▉▉▉▉▉▉▉▉▉▉▉▉▉▉▉▉▉▉▉▉▉▉▉▉▉▉▉▉▉▉▉▉▉▉▉▉▉▉▉▉▉▉▉▉▉▉▉▉▉▉▉▉▉▉▉▉▉▉▉▉▉▉▉▉▉▉▉▉▉▉▉▉▉▉▉▉▉▉▉▉▉▉▉▉▉▉▉▉▉▉▉▉▉▉▉▉▉▉▉▉▉▉▉▉▉░░░░░░░░░░                              ░░░░░░░░░░░░░░
░░░░░░░░░░▉▉▉▉▉▉▉▉▉▉▉▉▉▉▉▉▉▉▉▉▉▉▉▉▉▉▉▉▉▉▉▉▉▉▉▉▉▉▉▉▉▉▉▉▉▉▉▉▉▉▉▉▉▉▉▉▉▉▉▉▉▉▉▉▉▉▉▉▉▉▉▉▉▉▉▉▉▉▉▉▉▉▉▉▉▉▉▉▉▉▉▉▉▉▉▉▉▉▉▉▉▉▉▉▉▉▉▉▉▉▉▉▉▉▉▉▉▉▉▉▉▉▉▉▉▉▉▉▉▉▉▉▉▉▉▉░░░░░░░░░░                              ░░░░░░░░░░░░░░
░░░░░░░░░░▉▉▉▉▉▉▉▉▉▉▉▉▉▉▉▉▉▉▉▉▉▉                        ▉▉▉▉▉▉▉▉▉▉▉▉▉▉▉▉▉▉▉▉▉▉▉▉▉▉▉▉▉▉▉▉▉▉▉▉▉▉▉▉▉▉▉▉▉▉▉▉▉▉▉▉▉▉▉▉▉▉▉▉▉▉▉▉▉▉▉▉▉▉▉▉▉▉▉▉▉▉▉▉▉▉▉▉▉▉░░░░░░░░░░░░░░                              ░░░░░░░░░░░░░░
░░░░░░░░░░▉▉▉▉▉▉▉▉▉▉▉▉▉▉▉▉▉▉▉▉▉▉                        ▉▉▉▉▉▉▉▉▉▉▉▉▉▉▉▉▉▉▉▉▉▉▉▉░░░░░░░░░░░░░░░░░░░░░░░░░░                              ░░░░░░░░░░░░░░
░░░░░░░░░░▉▉▉▉▉▉▉▉▉▉▉▉▉▉▉▉▉▉▉▉▉▉                        ▉▉▉▉▉▉▉▉▉▉▉▉▉▉▉▉▉▉▉▉▉▉▉▉░░░░░░░░░░░░░░░░░░░░░░░░░░                              ░░░░░░░░░░░░░░
░░░░░░░░░░▉▉▉▉▉▉▉▉▉▉▉▉▉▉▉▉▉▉▉▉▉▉                        ▉▉▉▉▉▉▉▉▉▉▉▉▉▉▉▉▉▉▉▉▉▉▉▉░░░░░░░░░░░░░░░░░░░░░░░░░░                              ░░░░░░░░░░░░░░
░░░░░░░░░░▉▉▉▉▉▉▉▉▉▉▉▉▉▉▉▉▉▉▉▉▉▉                        ▉▉▉▉▉▉▉▉▉▉▉▉▉▉▉▉▉▉▉▉▉▉▉▉▉▉▉▉▉▉▉▉▉▉▉▉▉▉▉▉▉▉▉▉▉▉▉▉▉▉▉▉▉▉▉▉▉▉▉▉▉▉▉▉▉▉▉▉▉▉▉▉▉▉░░░░░░░░░░░░░░░░░░░░░░░░░░                              ░░░░░░░░░░░░░░
░░░░░░░░░░▉▉▉▉▉▉▉▉▉▉▉▉▉▉▉▉▉▉▉▉▉▉▉▉▉▉░░░░░░░░░░░░░░░░░░░░▉▉▉▉▉▉▉▉▉▉▉▉▉▉▉▉▉▉▉▉▉▉▉▉▉▉▉▉▉▉▉▉▉▉▉▉▉▉▉▉▉▉▉▉▉▉▉▉▉▉▉▉▉▉▉▉▉▉▉▉▉▉▉▉▉▉▉▉▉▉▉▉▉▉░░░░░░░░░░░░░░░░░░░░░░░░░░                              ░░░░░░░░░░░░░░
░░░░░░░░░░▉▉▉▉▉▉▉▉▉▉▉▉▉▉▉▉▉▉▉▉▉▉▉▉▉▉░░░░░░░░░░░░░░░░░░░░░░░░░░░░░░░░░░░░░░░░░░░░░░▉▉▉▉▉▉▉▉▉▉▉▉▉▉▉▉▉▉▉▉▉▉▉▉▉▉░░░░░░░░░░░░░░░░░░▎▎░░░░░░░░░░░░░░░░░░░░░░░░░░░░                              ░░░░░░░░░░░░░░
░░░░░░░░░░▉▉▉▉▉▉▉▉▉▉▉▉▉▉▉▉▉▉▉▉▉▉▉▉▉▉░░░░░░░░░░░░░░░░░░░░░░░░░░░░░░░░░░░░░░░░░░░░░░░░▉▉▉▉▉▉▉▉▉▉▉▉▉▉▉▉▉▉▉▉▉▉░░░░░░░░░░░░░░░░░░░░▎▎░░░░░░░░░░░░░░░░░░░░░░░░░░░░                              ░░░░░░░░░░░░░░
░░░░░░░░░░▉▉▉▉▉▉▉▉▉▉▉▉▉▉▉▉▉▉▉▉▉▉▉▉▉▉░░░░░░░░░░░░░░░░░░░░░░░░░░░░░░░░░░░░░░░░░░░░░░░░░░░░▉▉▉▉▉▉▉▉▉▉▉▉▉▉░░░░░░░░░░░░░░░░░░░░░░░░▎▎░░░░░░░░░░░░░░░░░░░░░░░░░░░░                              ░░░░░░░░░░░░░░
░░░░░░░░░░▉▉▉▉▉▉▉▉▉▉▉▉▉▉▉▉▉▉▉▉▉▉░░░░░░░░░░░░░░░░░░░░░░░░░░░░░░░░░░░░░░░░░░░░░░░░░░░░░░░░░░░░░░░░░░░░░░░░░░░░░░░░░░░░░░░░░░░░░░▎▎░░░░░░░░░░░░░░░░░░░░░░░░░░░░                              ░░░░░░░░░░░░░░
░░░░░░░░░░▉▉▉▉▉▉▉▉▉▉▉▉▉▉▉▉▉▉▉▉▉▉▉▉▉▉▉▉▉▉▉▉░░░░░░░░░░░░░░░░░░░░░░░░░░░░░░░░░░░░░░░░░░░░░░░░░░░░░░░░░░░░░░░░░░░░░░░░░░░░░░░░░░░░▎▎░░░░░░░░░░░░░░░░░░░░░░░░░░░░                              ░░░░░░░░░░░░░░
░░░░░░░░░░▉▉▉▉▉▉▉▉▉▉▉▉▉▉▉▉▉▉▉▉▉▉▉▉▉▉▉▉▉▉▉▉░░░░░░░░░░░░░░░░░░░░░░░░░░░░░░░░░░░░░░░░░░░░░░░░░░░░░░░░░░░░░░░░░░░░░░░░░░░░░░░░▉▉▉▉▉▉▉▉▉▉░░░░░░░░░░░░░░░░░░░░░░░░                              ░░░░░░░░░░░░░░
░░░░░░░░░░▉▉▉▉▉▉▉▉▉▉▉▉▉▉▉▉▉▉▉▉▉▉▉▉▉▉▉▉▉▉▉▉░░░░░░░░░░░░░░░░░░░░░░░░░░░░░░░░░░░░░░░░░░░░░░░░░░░░░░░░░░░░░░░░░░░░░░░░░░░░░░░░▉▉▉▉▉▉▉▉▉▉░░░░░░░░░░░░░░░░░░░░░░░░                              ░░░░░░░░░░░░░░
░░░░░░░░░░▉▉▉▉▉▉▉▉▉▉▉▉▉▉▉▉▉▉▉▉▉▉▉▉▉▉▉▉▉▉▉▉░░░░░░░░░░░░░░░░░░░░░░░░░░░░░░░░░░░░░░░░░░░░░░░░░░░░░░░░░░░░░░░░░░░░░░░░░░░░░░░░▉▉▉▉▉▉▉▉▉▉░░░░░░░░░░░░░░░░░░░░░░░░                              ░░░░░░░░░░░░░░
░░░░░░░░░░▉▉▉▉▉▉▉▉▉▉▉▉▉▉▉▉▉▉▉▉▉▉░░░░░░░░░░░░░░░░░░░░░░░░░░░░░░░░░░░░░░░░░░░░░░░░░░░░░░░░░░░░░░░░░░░░░░░░░░░░░░░░░░░░░░░░░░▉▉▉▉▉▉▉▉▉▉░░░░░░░░░░░░░░░░░░░░░░░░                              ░░░░░░░░░░░░░░
░░░░░░░░░░▉▉▉▉▉▉▉▉▉▉▉▉▉▉▉▉▉▉▉▉▉▉░░░░░░░░░░░░░░░░░░░░░░░░░░░░░░░░░░░░░░░░░░░░░░░░░░░░░░░░░░░░░░░░░░░░░░░░░░░░░░░░░░░░░░░░░░▉▉▉▉▉▉▉▉▉▉░░░░░░░░░░░░░░░░░░░░░░░░                              ░░░░░░░░░░░░░░
░░░░░░░░░░▉▉▉▉▉▉▉▉▉▉▉▉▉▉▉▉▉▉▉▉▉▉▉▉▉▉░░░░░░░░░░░░░░░░░░░░░░░░░░░░░░░░░░░░░░░░░░░░░░░░░░░░░░░░░░░░░░░░░░░░░░░░░░░░░░░░░░░░░░░░░░░░░░░░░░░░░░░░░░░░░░░░░░░░░░░░                              ░░░░░░░░░░░░░░
░░░░░░░░░░▉▉▉▉▉▉▉▉▉▉▉▉▉▉▉▉▉▉▉▉▉▉▉▉▉▉░░░░░░░░░░░░░░░░░░░░░░░░░░░░░░░░░░░░░░░░░░░░░░░░░░░░░░░░░░░░░░░░░░░░░░░░░░░░░░░░░░░░░░░░░░░░░░░░░░░░░░░░░░░░░░░░░░░░░░░░                              ░░░░░░░░░░░░░░
░░░░░░░░░░▉▉▉▉▉▉▉▉▉▉▉▉▉▉▉▉▉▉▉▉▉▉▉▉▉▉░░░░░░░░░░░░░░░░░░░░░░░░░░░░░░░░░░░░░░░░░░░░░░░░░░░░░░░░░░░░░░░░░░░░░░░░░░░░░░░░░░░░░░░░░░░░░░░░░░░░░░░░░░░░░░░░░░░░░░░░                              ░░░░░░░░░░░░░░
░░░░░░░░░░▉▉▉▉▉▉▉▉▉▉▉▉▉▉▉▉▉▉▉▉▉▉▉▉▉▉░░░░░░░░░░░░░░░░░░░░░░░░░░░░░░░░░░░░░░░░░░░░░░░░░░░░░░░░░░░░░░░░░░░░░░░░░░░░░░░░░░░░░░░░░░░░░░░░░░░░░░░░░░░░░░░░░░░░░░░░                              ░░░░░░░░░░░░░░
░░░░░░░░░░▉▉▉▉▉▉▉▉▉▉▉▉▉▉▉▉▉▉▉▉▉▉░░░░░░░░░░░░░░░░░░░░░░░░░░░░░░░░░░░░░░░░░░░░░░░░░░░░░░░░░░░░░░░░░░░░░░░░░░░░░░░░░░░░░░░░░░░░░░░░░░░░░░░░░░░░░░░░░░░░░░░░░░░░                              ░░░░░░░░░░░░░░
░░░░░░░░░░▉▉▉▉▉▉▉▉▉▉▉▉▉▉▉▉▉▉▉▉▉▉░░░░░░░░░░░░░░░░░░░░░░░░░░░░░░░░░░░░░░░░░░░░░░░░░░░░░░░░░░░░░░░░░░░░░░░░░░░░░░░░░░░░░░░░░░▉▉▉▉▉▉▉▉▉▉░░░░░░░░░░░░░░░░░░░░░░░░                              ░░░░░░░░░░░░░░
░░░░░░░░░░░░░░░░░░▎▎░░░░░░░░░░░░░░░░░░░░░░░░░░░░░░░░░░░░░░░░░░░░░░░░░░░░░░░░░░░░░░░░░░░░░░░░░░░░░░░░░░░░░░░░░░░░░░░░░░░░░░▉▉▉▉▉▉▉▉▉▉░░░░░░░░░░░░░░░░░░░░░░░░                              ░░░░░░░░░░░░░░
░░░░░░░░░░░░░░░░░░▎▎░░░░░░░░░░░░░░░░░░░░░░░░░░░░░░░░░░░░░░░░░░░░░░░░░░░░░░░░░░░░░░░░░░░░░░░░░░░░░░░░░░░░░░░░░░░░░░░░░░░░░░▉▉▉▉▉▉▉▉▉▉░░░░░░░░░░░░░░░░░░░░░░░░                              ░░░░░░░░░░░░░░
░░░░░░░░░░░░░░░░░░▎▎░░░░░░░░░░░░░░░░░░░░░░░░░░░░░░░░░░░░░░░░░░░░░░░░░░░░░░░░░░░░░░░░░░░░░░░░░░░░░░░░░░░░░░░░░░░░░░░░░░░░░░▉▉▉▉▉▉▉▉▉▉░░░░░░░░░░░░░░░░░░░░░░░░                              ░░░░░░░░░░░░░░
░░░░░░░░░░░░░░░░░░▎▎░░░░░░░░░░░░░░░░░░░░░░░░░░░░░░░░░░░░░░░░░░░░░░░░░░░░░░░░░░░░░░░░░░░░░░░░░░░░░░░░░░░░░░░░░░░░░░░░░░░░░░▉▉▉▉▉▉▉▉▉▉░░░░░░░░░░░░░░░░░░░░░░░░                              ░░░░░░░░░░░░░░
░░░░░░░░░░░░░░░░░░▎▎░░░░░░░░░░░░░░░░░░░░░░░░░░░░░░░░░░░░░░░░░░░░░░░░░░░░░░░░░░░░░░░░░░░░░░░░░░░░░░░░░░░░░░░░░░░░░░░░░░░░░░░░░░▎▎░░░░░░░░░░░░░░░░░░░░░░░░░░░░                              ░░░░░░░░░░░░░░
░░░░░░░░░░░░░░░░░░▎▎░░░░░░░░░░░░░░░░░░░░░░░░░░░░░░░░░░░░░░░░░░░░░░░░░░░░░░░░░░░░░░░░░░░░░░░░░░░░░░░░░░░░░░░░░░░░░░░░░░░░░░░░░░▎▎░░░░░░░░░░░░░░░░░░░░░░░░░░░░                              ░░░░░░░░░░░░░░
░░░░░░░░░░░░░░░░░░▎▎░░░░░░░░░░░░░░░░░░░░░░░░░░░░░░░░░░░░░░░░░░░░░░░░░░░░░░░░░░░░░░░░░░░░░░░░░░░░░░░░░░░░░░░░░░░░░░░░░░░░░░░░░░▎▎░░░░░░░░░░░░░░░░░░░░░░░░░░░░                              ░░░░░░░░░░░░░░
░░░░░░░░░░░░░░░░░░▎▎░░░░░░░░░░░░░░░░░░░░░░░░░░░░░░░░░░░░░░░░░░░░░░░░░░░░░░░░░░░░░░░░░░░░░░░░░░░░░░░░░░░░░░░░░░░░░░░░░░░░░░░░░░▎▎░░░░░░░░░░░░░░░░░░░░░░░░░░░░↓ ↓ ↓ ↓ ↓ ↓ ↓ ↓ ↓ ↓ ↓ ↓ ↓ ↓ ↓ ░░░░░░░░░░░░░░",
    "init_pos": [56,170],
    "exits": {
        "61,156" : ["SC",[1,136]],
        "61,157" : ["SC",[1,137]],
        "61,158" : ["SC",[1,138]],
        "61,159" : ["SC",[1,139]],
        "61,160" : ["SC",[1,140]],
        "61,161" : ["SC",[1,141]],
        "61,162" : ["SC",[1,142]],
        "61,163" : ["SC",[1,143]],
        "61,164" : ["SC",[1,144]],
        "61,165" : ["SC",[1,145]],
        "61,166" : ["SC",[1,146]],
        "61,167" : ["SC",[1,147]],
        "61,168" : ["SC",[1,148]],
        "61,169" : ["SC",[1,149]],
        "61,170" : ["SC",[1,150]],
        "61,171" : ["SC",[1,151]],
        "61,172" : ["SC",[1,152]],
        "61,173" : ["SC",[1,153]],
        "61,174" : ["SC",[1,154]],
        "61,175" : ["SC",[1,155]],
        "61,176" : ["SC",[1,156]],
        "61,177" : ["SC",[1,157]],
        "61,178" : ["SC",[1,158]],
        "61,179" : ["SC",[1,159]],
        "61,180" : ["SC",[1,160]],
        "61,181" : ["SC",[1,161]],
        "61,182" : ["SC",[1,162]],
        "61,183" : ["SC",[1,163]],
        "61,184" : ["SC",[1,164]],
        "61,185" : ["SC",[1,165]]
},
    "items": {
        "Side Quest 1": [11, 0]
    }
}