{
    "name": "H7 Study Room",
    "raw": "▉▉▉▉▉▉▉▉▉▉▉▉▉▉▉▉▉▉▉▉▉▉▉▉▉▉▉▉▉▉▉▉▉▉▉▉▉▉▉▉▉▉▉▉▉▉▉▉▉▉▉▉▉▉▉▉▉▉▉▉▉▉▉▉▉▉▉▉▉▉▉
▉                      ▉▉▉▉▉▉▉▉▉▉▉▉▉▉▉▉▉▉▉▉▉▉▉▉                       ▉
▉                                                                     ▉
▉                                                                     ▉
▉                                                                     ▉
▉                                                                     ▉
▉                                                                     ▉
▉                                                                     ▉
▉                                                                     ▉
▉                                                                     ▉
▉                                                                     ▉
▉                                                                     ▉
▉                                                                     ▉
▉                                                                     ▉
▉                                                                     ▉
▉                                                                     ▉
▉                                                                     ▉
▉                                                                     ▉
▉                                                                     ▉
▉                                                                     ▉
▉          ▉▉▉▉▉▉▉▉▉▉▉▉                ▉▉▉▉▉▉▉▉▉▉▉▉                   ▉
▉          ▉▉▉▉▉▉▉▉▉▉▉▉                ▉▉▉▉▉▉▉▉▉▉▉▉                   ▉
▉          ▉▉▉▉▉▉▉▉▉▉▉▉                ▉▉▉▉▉▉▉▉▉▉▉▉                   ▉
▉          ▉▉▉▉▉▉▉▉▉▉▉▉                ▉▉▉▉▉▉▉▉▉▉▉▉                   ▉
▉          ▉▉▉▉▉▉▉▉▉▉▉▉                ▉▉▉▉▉▉▉▉▉▉▉▉                   ▉
▉          ▉▉▉▉▉▉▉▉▉▉▉▉                ▉▉▉▉▉▉▉▉▉▉▉▉                   ▉
▉          ▉▉▉▉▉▉▉▉▉▉▉▉                ▉▉▉▉▉▉▉▉▉▉▉▉                   ▉
▉          ▉▉▉▉▉▉▉▉▉▉▉▉                ▉▉▉▉▉▉▉▉▉▉▉▉                   ▉
▉          ▉▉▉▉▉▉▉▉▉▉▉▉                ▉▉▉▉▉▉▉▉▉▉▉▉                   ▉
▉          ▉▉▉▉▉▉▉▉▉▉▉▉                ▉▉▉▉▉▉▉▉▉▉▉▉                   ▉
▉          ▉▉▉▉▉▉▉▉▉▉▉▉                ▉▉▉▉▉▉▉▉▉▉▉▉                   ▉
▉          ▉▉▉▉▉▉▉▉▉▉▉▉                ▉▉▉▉▉▉▉▉▉▉▉▉                   ▉
▉                                                                     ▉
▉                                                                     ▉
▉                                                                     ▉
▉▉▉▉▉▉▉▉▉▉▉▉▉▉▉▉▉▉▉▉▉▉▉▉▉▉▉▉▉▉▉▉▉▉▉▉▉▉▉▉▉▉▉▉▉▉▉▉▉▉▉▉▉▉▉▉▉▉▉▉▉▉▉▉▉▉▉▉▉▉▉",
    "init_pos": [20,30],
    "exits": {},
    "items": {
        "Teleporter": [1, 1],
        "Campus Map": [34, 28]
    }
}
