{
    "name": "Hostel 7 Floor 8",
    "raw": "````````````````````````````````````````````````````````````````````````````````````````````````````````````````````````````````````````````````````````````````````````````````````````````````````````
````````````````````````````````````````````````````````````````````````````````````````````````````````````````````````````````````````````````````````````````````````````````````````````````````````
````````````````````````````````````````````````````````````````````````````````````````````````````````````````````````````````````````````````````````````````````````````````````````````````````````
````````````````````````````````````````````````````````````````````````````````````````````````````````````````````````````````````````````````````````````````````````````````````````````````````````
````````````````````````````````````````````````````````````````````````````````````````````````````````````````````````````````````````````````````````````````````````````````````````````````````````
````````````````````````````````````````````````````````````````````````````````````````````````````````````````````````````````````````````````````````````````````````````````````````````````````````
````````````````````````````````````````````````````````````````````````````````````````````````````````````````````````````````````````````````````````````````````````````````````````````````````````
````````````````````````````````````````````````````````````````````````````````````````````````````````````````````````````````````````````````````````````````````````````````````````````````````````
````````````````````````````````````````````````````````````````````````````````````````````````````````````````````````````````````````````````````````````````````````````````````````````````````````
````````````````````````````````````````````````````````````````````````````````````````````````````````````````````````````````````````````````````````````````````````````````````````````````````````
````````````````````````````````````````````````````````````````````````````````````````````````````````````````````````````````````````````````````````````````````````````````````````````````````````
````````````````````````````````````````````````````````````````````````````````````````````````````````````````````````````````````````````````````````````````````````````````````````````````````````
````````````````````````````````````````````````````````````````````````````````````````````````````````````````````````````````````````````````````````````````````````````````````````````````````````
````````````````````````````````````````````````````````````````````````````````````````````````````````````````````````````````````````````````````````````````````````````````````````````````````````
````````````````````````````````````````````````````````````````````````````````````````````````````````````````````````````````````````````````````````````````````````````````````````````````````````
````````````````````````````````````````````````````````````````````````````````````````````````````````````````````````````````````````````````````````````````````````````````````````````````````````
````````````````````````````````````````````````````````````````````````````````````````````````````````````````````````````````````````````````````````````````````````````````````````````````````````
````````````````````````````````````````````````````````````````````````````````````````````````````````````````````````````````````````````````````````````````````````````````````````````````````````
``┌..─..───────────────────────┐``````````````````````````````````````````````````````````````````````````````````````````````````````````````````````````````````````````┌───────────────────..─..┐````
``│                            │``````````````````````````````````````````````````````````````````````````````````````````````````````````````````````````````````````````│                        │````
``│                            │``````````````````````````````````````````````````````````````````````````````````````````````````````````````````````````````````````````│                        │````
``│                            │``````````````````````````````````````````````````````````````````````````````````````````````````````````````````````````````````````````│                        │````
``└────────────────────┐       │``````````````````````````````````````````````````````````````````````````````````````````````````````````````````````````````````````````│       ┌────────────────┘````
```````````````````````│       │``````````````````````````````````````````````````````````````````````````````````````````````````````````````````````````````````````````│       │`````````````````````
```````````````````````│       │``````````````````````````````````````````````````````````````````````````````````````````````````````````````````````````````````````````│       │`````````````````````
```````````````````````│       │``````````````````````````````````````````````````````````````````````````````````````````````````````````````````````````````````````````│       │`````````````````````
```````````````````````│       │``````````````````````````````````````````````````````````````````````````````````````````````````````````````````````````````````````````│       │`````````````````````
```````````````````````│       │``````````````````````````````````````````````````````````````````````````````````````````````````````````````````````````````````````````│       │`````````````````````
```````````````````````│       │``````````````````````````````````````````````````````````````````````````````````````````````````````````````````````````````````````````│       │`````````````````````
```````````````````````│       │``````````````````````````````````````````````````````````````````````````````````````````````````````````````````````````````````````````│       │`````````````````````
```````````````````````│       │``````````````````````````````````````````````````````````````````````````````````````````````````````````````````````````````````````````│       │`````````````````````
```````````````````````│       │``````````````````````````````````````````````````````````````````````````````````````````````````````````````````````````````````````````│       │`````````````````````
``┌────────────────────┘       │``````````````````````````````````````````````````````````````````````````````````````````````````````````````````````````````````````````│       └─────────────────┐```
``│                            │``````````````````````````````````````````````````````````````````````````````````````````````````````````````````````````````````````````│                         │```
``│                            │``````````````````````````````````````````````````````````````````````````````````````````````````````````````````````````````````````````│                         │```
``│                            │``````````````````````````````````````````````````````````````````````````````````````````````````````````````````````````````````````````│                         │```
``│                            │``````````````````````````````````````````````````````````````````````````````````````````````````````````````````````````````````````````│                         │```
``│                            │``````````````````````````````````````````````````````````````````````````````````````````````````````````````````````````````````````````│                         │```
``│                            │``````````````````````````````````````````````````````````````````````````````````````````````````````````````````````````````````````````│                         │```
``│                            │``````````````````````````````````````````````````````````````````````````````````````````````````````````````````````````````````````````│                         │```
``│                            │``````````````````````````````````````````````````````````````````````````````````````````````````````````````````````````````````````````│                         │```
``└────────────────────┐       │``````````````````````````````````````````````````````````````````````````````````````````````````````````````````````````````````````````│       ┌─────────────────┘```
```````````````````````│       │``````````````````````````````````````````````````````````````````````````````````````````````````````````````````````````````````````````│       │`````````````````````
```````````````````````│       │``````````````````````````````````````````````````````````````````````````````````````````````````````````````````````````````````````````│       │`````````````````````
```````````````````````│       │``````````````````````````````````````````````````````````````````````````````````````````````````````````````````````````````````````````│       │`````````````````````
```````````````````````│       │``````````````````````````````````````````````````````````````````````````````````````````````````````````````````````````````````````````│       │`````````````````````
```````````````````````│       │``````````````````````````````````````````````````````````````````````````````````````````````````````````````````````````````````````````│       │`````````````````````
```````````````````````│       │``````````````````````````````````````````````````````````````````````````````````````````````````````````````````````````````````````````│       │`````````````````````
```````````````````````│       │``````````````````````````````````````````````````````````````````````````````````````````````````````````````````````````````````````````│       │`````````````````````
```````````````````````│       │``````````````````````````````````````````````````````````````````````````````````````````````````````````````````````````````````````````│       │`````````````````````
```````````````````````│       │``````````````````````````````````````````````````````````````````````````````````````````````````````````````````````````````````````````│       │`````````````````````
```````````````````````│       │``````````````````````````````````````````````````````````````````````````````````````````````````````````````````````````````````````````│       │`````````````````````
```````````````````````│       │``````````````````````````````````````````````````````````````````````````````````````````````````````````````````````````````````````````│       │`````````````````````
```````````````````````│       :``````````````````````````````````````````````````````````````````````````````````````````````````````````````````````````````````````````:       │`````````````````````
```````````````````````│       :``DOWN````````````````````````````````````````````````````````````````````````````````````````````````````````````````````````````````````:       │`````````````````````
```````````````````````│       :``````````````````````````````````````````````````````````````````````````````````````````````````````````````````````````````````````````:       │`````````````````````
```````````````````````│       └───────────┐``````````````````````````````````````````````````````````````````````````````````````````````````````````````````┌───────────┘       │`````````````````````
```````````````````````│                   │``````````````````````````````````````````````■■■■■■■■````````■■■■````````````````````````````````````````````````│                   |`````````````````````
```````````````````````└──┐                │``````````````````````````````````````````````■■`````````````■````■```````````````````````````````````````````````│                ┌──┘`````````````````````
``````````````````````````│                │``````````````````````````````````````````````■■■■■````■■■````■■■■````````````````````````````````````````````````│                │````````````````````````
``````````````````````````└───┐            │``````````````````````````````````````````````■■`````````````■````■```````````````````````````````````````````````│            ┌───┘````````````````````````
``````````````````````````````│            │``````````````````````````````````````````````■■``````````````■■■■````````````````````````````````````````````````│            │````````````````````````````
``````````````````````````````└───┐        │``````````````````````````````````````````````````````````````````````````````````````````````````````````````````│        ┌───┘````````````````````````````
``````````````````````````````````│        └────────────────────────────────────────────────────────────────────────────────────────────────────────────......┘        │````````````````````````````````
``````````````````````````````````└───┐                                                                                                                            ┌───┘````````````````````````````````
``````````````````````````````````````│                                                                                                                            │````````````````````````````````````
``````````````````````````````````````└───┐                                                                                                                    ┌───┘````````````````````````````````````
``````````````````````````````````````````|          ┌──────────────────────────────────┐                        ┌──────────────────────────────────┐          │````````````````````````````````````````
``````````````````````````````````````````└───┐      │``````````````````````````````````│                        │``````````````````````````````````│      ┌───┘````````````````````````````````````````
``````````````````````````````````````````````|      │``````````````````````````````````│                        │``````````````````````````````````│      |````````````````````````````````````````````
``````````````````````````````````````````````│      │``````````````````````````````````│                        │``````````````````````````````````│      │````````````````````````````````````````````
``````````````````````````````````````````````└──────┘``````````````````````````````````│                        │``````````````````````````````````└──────┘````````````````````````````````````````````
````````````````````````````````````````````````````````````````````````````````````````│                        │``````````````````````````````````````````````````````````````````````````````````````
````````````````````````````````````````````````````````````````````````````````````````│                        │``````````````````````````````````````````````````````````````````````````````````````
````````````````````````````````````````````````````````````````````````````````````````│                        │``````````````````````````````````````````````````````````````````````````````````````
````````````````````````````````````````````````````````````````````````````````````````│                        │``````````````````````````````````````````````````````````````````````````````````````
````````````````````````````````````````````````````````````````````````````````````````│                        │``````````````````````````````````````````````````````````````````````````````````````
````````````````````````````````````````````````````````````````````````````````````````│                        │``````````````````````````````````````````````````````````````````````````````````````
````````````````````````````````````````````````````````````````````````````````````````│                        │``````````````````````````````````````````````````````````````````````````````````````
````````````````````````````````````````````````````````````````````````````````````````└────────────────────────┘``````````````````````````````````````````````````````````````````````````````````````",
    "init_pos": [73, 100],
    "exits": {
			"53,31" : ["Hostel 7 Floor 7", [63, 48]],
			"54,31" : ["Hostel 7 Floor 7", [63, 48]],
			"55,31" : ["Hostel 7 Floor 7", [63, 48]]
		},
    "items": {}
}