
{
    "name": "Labyrinth",
    "raw": "╔═══════▊▊══════════════════════════════▊══════════════▊═════════════════════▊▊▊═══════════╗                                             
║                   ▊           ▊                                 ▊                         ▊                                             
║   ▊                     ▊             ▊                                                    ║                                             
▊        ╔═══════════════════════════════▊▊═════════════▊═══════════════▊════════════╗       ║       ╔══════════════════════════▊▊═══════╗
▊▊      ║░░░░░░░░░░░░░░░░░░░░░░░░░░░░░▊▊▊▊▊░░░░░░░░░░░░░░░░░░░░░░░░░░░░░░░░░░░░░░░║       ║   ▊   ║            ▊               ▊      ║
║▊     ║░░░░░░░▊▊░░░░░░░░░░░░░░░░░░░░▊▊░░▊▊░░░░░░░░░░░░░░░░░░░░░░▊░░░▊░░░░░░░░░░║       ║  ▊▊   ▊                                   ║
║ ▊▊    ║░░░░░░▊▊▊▊░░░░░░░░░░░░░░░░░░▊░░░▊▊▊░░░░░░░░░░░░░░░░░░░░░░░▊▊░░░░░░░░░░║       ║ ▊▊    ▊▊▊     ╔════════════════════╗       ║
║  ▊     ║░░░░░▊▊░▊▊░░░░░░░░░░░░░░░░░░░░░░▊▊░░░░░░░░░░░░░░░░░░░░░░░░░▊▊▊░░░░░░░░░░║       ║ ▊    ║ ▊    ║░░░░░░░░░░░░░░░░░░░░║       ║
║        ║░░░░░▊░░░░░░░░░░░░░░░░░░░░░░░░░░░░▊▊░░░░░░░░░░░░░░░░░░░░░░░▊░░░░░░░░░░░░░║       ║  ▊▊  ▊       ║░░░░░░░░░░░▊░░░░░░░░║     ▊▊
║        ║░░░░▊▊░┏━━━━━━━━━━━━━━━━━━━━━━━━━━━━▊━━━━∴━━━━━━━━━━━━━━━━━▊━━━━━━━━━━━━━━╩┈┈┈┈┈┈┈╩━━┳▊━━━▊┅┅┅┅┅┅┅╩━━━━━━━━━━▊━┓░░░░░░░║    ▊ ║
║        ▊░░░░▊▊░←                                                  ▊                         ▊▊▊▊▊               ▊ ▊  ┃░░░░░░░║    ▊ ║
   ▊   ▊░░░░░▊░░←       ▊                                ▊                                    ▊  ▊                  ▊▊▊ ┃░░░░░░░║   ▊▊  ║
       ▊▊░░░░▊░░←       ▊▊                            ▊▊                      ▊             ▊▊▊  ▊▊                  ▊ ┃░░░░░░░║   ▊   ║
       ░▊▊░░░░░░┣━━━━━━▊░▊━━━━━━━━━━━━━━━━━━━┬━━━━━━━━━━━━━━━━━━━━━━━━━━━▊▊━━━━━━━━━━━━▊▊┻━━━▊▊━━━━━━━━━┓  ▊      ┃░░░░░░░║       ║
║      ▊▊░▊▊░░░░░┃       ▊                                               ▊▊           ▊▊ ▊     ▊         ┃   ▞    ┃░░░░ ░░░║       ║
║     ▊▊ ║░░▊░░░░┃    ░    ▊                       ▊     ▊▊              ▊▊   ▊            ▊                   ┃   ▊▊   ┃░░░░░░░║       ║
    ▊  ║░░░▊░░░░┃   ░        ▊▊                 ▊▊   ▊                 ▊▊▊                                  ┃    ▊▊▊▊░░░ ░░║   ▊   ║
║    ▊   ║░░░░░▊░░┃         ┏━━━━━▊━▊━━━━━━━━━━━━━━▊▊━━▊▊━━━━━┬━━━┬━━┬━━━━━━▊▊▊━━━━━━━━━━━━━━━━━▞▊▊━┓         ┃    ▊ ▊┃░░░░░░░▊▊▊   ║
║        ║░░░▊░░░░       ┃      ▊              ▊▊ ▊                      ▊                  ▞▞┃         ┃    ▊▊ ▊░░░░░░░▊▊ ▊    ║
║        ║░░▊▊░░░░░        ┃                «       ▊▊                                           ▞▞▞         ┃   ▊     ▊▊░ ░░░░║       ║
║        ║░░░▊░░░░         ▊                   ▊▊                           ┃                        ▞▊        ┃   ▊    ┃▊░░░░░░║       ║
║  ▊     ║░░░░░░░┃░       ▊         ┏━━━━━━━━━▊━━━━━━━━▊▊━━━━━━━━━━━━━━━▊━┃━▊▊━━━━━━━━━━━━┓         ▞▞▞       ┃     ▊   ▞▊░░░░░░        ║
║ ▊▊    ║░░░░▊░░┃ ░░     ▊      ▊  ┃         ▊          ▊▊            ▊▊┃▊▊            ┃         ┃▊▊               ▞▞▊░░░░░        ║
║▊ ▊  ║░░▊░░░┃         ┃     ▊  ┃                    ▊▊▊             ▊▊              ┃         ┃  ▊      ┃         ┃▞▞▞░░░░║▊      ║
▊▊   ▊▊  ║░▊▊▊▊░░┃         ┃     ▊  ┃                     ▊                               ┃ ┃        ┃         ┃  ▊      ┃░▞░░ ░║       ▊
        ║░░░▊▊░░┃ ░   ▊   ┃    ▊▊  ┃        ┏⌧━ ━━━━━━━▊━━━━━━━━━━━━━━━━━━━━━━┓        ┃         ┃         ┃ ▊▊     ┃░░░  ░║      ║
║        ╚══════╣ ░░ ▊   ┃     ▊ ┃        ┃            ▊   ┌── ──┐             ┃       ┃ ┃        ┃         ┃▊ ▊▊   ┃░░░░ ░░║     ▊║
║                ┊  ░▊▊    ┃      ▊▊        ┃                │┌   ┐│            ┃        ┃         ┛         ▊   ▊    ┃░░░░░░░║    ▊  ▊
║                ┊ ▊▊  ░┃        ▊▊       ┃                              ▊▊            ┃ ┃                  ▊         ┃░░░░░░░║       ▊
╚═════════════════╣ ▊  ░  ┃         ▊▊ ▊    ┃        ▊▊     │└   ┘│        ▊▊             ┃                   ┃         ┃░ ░ ░░║       ║
                  ┃░░░▊▊▊▊░┃         ┃▊▊▊▊    ┃         ▊▊▊ └── ──┘        ▊▊            ┃                   ┃         ┃░░  ░░░║       ║
                  ┣━━━━▊▊▊━━┛         ┃ ▊▊    ⌧━━━━━━━━━━━▊▊▊━━━━⌧━━━━━━━━━━━━▊▊━━━━━━━━━━▊┛         ┳━━━━━━━━━┛         ┃░░░░ ░░║       ║
                  ┃    ▊            « ┃                    ▊▊     ┃           ▊▊▊▊▊       ▊          ┇                  ┃░░▞░░ ░║       ║
                  ┃        ▊    ▊    ▊                     ▊      ┃          ▊▊  ▊▊▊    ▊▊           ┇         ▊         ┃░▞░░░░▊       ║
                  ┃        ▊ ▊▊     ▊                            ┃          ▊▊  ▊▊▊  ▊▊           ┇        ▊▊       ┃░▞░░░░▊       ║
                  ▛━━━━━━▊▊▊━▊━━━━━━▊━━━━━⌧━━━╦┅┅┅┅┅┅┅╦━━━━━━━━━┻━━━━━━━━━▊▊━━━━━▊▊▊▊━━━━━━━━━━━━┻━━━━━━━▊▊▊▊▊━━━┛░▞░░░░░║      ║
                                                 ║       ║░░░░░░░░░░░░░░░░░░▊▊▊░░░░░░░▊▊▊▊░░░░░░  ░ ░ ░░░░  ░░  ░░░  ░▊▊░░░ ░░░░░║  ▊     ║
                                                 ║▊      ║░░░░░░░░░░░░░░░░░▊▊░░░░░░░░░▊░░░░  ░░░ ░░ ░░░░  ░ ░░░░░░░░▊░░░░░░░░░ ░║       ▊
                                                 ▊▊▊     ╚══════════════▊▊▊═════════════▊▊▊══════   ══════════░░░░░░═══▊═════════  ╝      ▊
                                                 ║▊▊▊                                     ▊                  ░░░░                      ▊ ▊
                                                 ║  ▊           ▊▊▊             ▊                         ░░░░                      ▊▊▊
                                                 ╚════════════▊▊═══════════════▊▊▊═  ═══════════▊▊══════░░░░═════════════════════▊▊════▊
",
      "init_pos": [11, 105],
      "exits": {
          "10,18" : ["CAF",[28,130]],
          "11,18" : ["CAF",[29,130]],
          "12,18" : ["CAF",[30,130]]
      },
      "items": {
          "Terminal 1": [11, 94],
          "Terminal 2": [33, 22],
          "Terminal 3": [11, 104],
          "Trigger": [26, 51],
          "God Mode": [28, 67],
          "???": [11, 24]
          }
}