
{
    "name": "Labyrinth",
    "raw": "╔══════════════════════════════════════════════════════════════════════════════════════════════╗                                             
║                                                                                              ║                                             
║                                                                                              ║                                             
║        ╔═════════════════════════════════════════════════════════════════════════════╗       ║       ╔════════════════════════════════════╗
║        ║░░░░░░░░░░░░░░░░░░░░░░░░░░░░░░░░░░░░░░░░░░░░░░░░░░░░░░░░░░░░░░░░░░░░░░░░░░░░░║       ║       ║                                    ║
║        ║░░░░░░░░░░░░░░░░░░░░░░░░░░░░░░░░░░░░░░░░░░░░░░░░░░░░░░░░░░░░░░░░░░░░░░░░░░░░░║       ║       ║                                    ║
║        ║░░░░░░░░░░░░░░░░░░░░░░░░░░░░░░░░░░░░░░░░░░░░░░░░░░░░░░░░░░░░░░░░░░░░░░░░░░░░░║       ║       ║       ╔════════════════════╗       ║
║        ║░░░░░░░░░░░░░░░░░░░░░░░░░░░░░░░░░░░░░░░░░░░░░░░░░░░░░░░░░░░░░░░░░░░░░░░░░░░░░║       ║       ║       ║░░░░░░░░░░░░░░░░░░░░║       ║
║        ║░░░░░░░░░░░░░░░░░░░░░░░░░░░░░░░░░░░░░░░░░░░░░░░░░░░░░░░░░░░░░░░░░░░░░░░░░░░░░║       ║       ║       ║░░░░░░░░░░░░░░░░░░░░║       ║
║        ║░░░░░░░░┏━━━━━━━━━━━━━━━━━━━━━━━━━━━━━━━━━━━━━━━━━━━━━━━━━━━━━━━━━━━━━━━━━━━━╩┈┈┈┈┈┈┈╩━━┳━━━━╩┅┅┅┅┅┅┅╩━━━━━━━━━━━━┓░░░░░░░║       ║
║        ║░░░░░░░░←                                                                               ┃                         ┃░░░░░░░║       ║
║        ║░░░░░░░░←                                                                           ⌨   ┃  ⌨                      ┃░░░░░░░║       ║
║        ║░░░░░░░░←                                                                               ┃                         ┃░░░░░░░║       ║
║        ║░░░░░░░░┣━━━━━━━━━━━━━━━━━━━━━━━━━━━━━━━━━━━━━━━━━━━━━━━━━━━━━━━━━━━━━━━━━━━━━━━━━━━━━━━┻━━━━━━━━━━━━━━━┓         ┃░░░░░░░║       ║
║        ║░░░░░░░░┃                                                                                               ┃         ┃░░░░░░░║       ║
║        ║░░░░░░░░┃                                                                                               ┃         ┃░░░░░░░║       ║
║        ║░░░░░░░░┃                                                                                               ┃         ┃░░░░░░░║       ║
║        ║░░░░░░░░┃         ┏━━━━━━━━━━━━━━━━━━━━━━━━━━━━━━━━━━━━━━━━━━━━━━━━━━━━━━━━━━━━━━━━━━━━━━━━━━━┓         ┃         ┃░░░░░░░║       ║
║        ║░░░░░░░░┃         ┃                                                                           ┃         ┃         ┃░░░░░░░║       ║
║        ║░░░░░░░░┃         ┃                                                                           ┃         ┃         ┃░░░░░░░║       ║
║        ║░░░░░░░░┃         ┃                                                                           ┃         ┃         ┃░░░░░░░║       ║
║        ║░░░░░░░░┃         ┃         ┏━━━━━━━━━━━━━━━━━━━━━━━━━━━━━━━━━━━━━━━━━━━━━━━━━━━━━━━┓         ┃         ┃         ┃░░░░░░░║       ║
║        ║░░░░░░░░┃         ┃         ┃                                                       ┃         ┃         ┃         ┃░░░░░░░║       ║
║        ║░░░░░░░░┃         ┃         ┃                                                       ┃         ┃         ┃         ┃░░░░░░░║       ║
║        ║░░░░░░░░┃         ┃         ┃                                                       ┃         ┃         ┃         ┃░░░░░░░║       ║
║        ║░░░░░░░░┃         ┃         ┃        ┏━━━━━━━━━━━━━━━━━━━━━━━━━━━━━━━━━━━━━┓        ┃         ┃         ┃         ┃░░░░░░░║       ║
║        ╚════════╣         ┃         ┃        ┃                                     ┃        ┃         ┃         ┃         ┃░░░░░░░║       ║
║                 ┊         ┃         ┃        ┃                                     ┃        ┃         ┛         ┃         ┃░░░░░░░║       ║
║                 ┊         ┃         ┃        ┃                 ◲◱                           ┃                   ┃         ┃░░░░░░░║       ║
╚═════════════════╣         ┃         ┃        ┃                 ◳◰                           ┃                   ┃         ┃░░░░░░░║       ║
                  ┃         ┃         ┃        ┃                                              ┃                   ┃         ┃░░░░░░░║       ║
                  ┣━━━━━━━━━┛         ┃        ┗━━━━━━━━━━━━━━━━━━━┳━━━━━━━━━━━━━━━━━━━━━━━━━━┛         ┳━━━━━━━━━┛         ┃░░░░░░░║       ║
                  ┃                   ┃                            ┃                                    ┇                   ┃░░░░░░░║       ║
                  ┃  ⌨                ┃                            ┃                                    ┇                   ┃░░░░░░░║       ║
                  ┃                   ┃                            ┃                                    ┇                   ┃░░░░░░░║       ║
                  ┗━━━━━━━━━━━━━━━━━━━┻━━━━━━━━━━╦┅┅┅┅┅┅┅╦━━━━━━━━━┻━━━━━━━━━━━━━━━━━━━━━━━━━━━━━━━━━━━━┻━━━━━━━━━━━━━━━━━━━┛░░░░░░░║       ║
                                                 ║       ║░░░░░░░░░░░░░░░░░░░░░░░░░░░░░░░░░░░░░░░░░░░░░░░░░░░░░░░░░░░░░░░░░░░░░░░░░░║       ║
                                                 ║       ║░░░░░░░░░░░░░░░░░░░░░░░░░░░░░░░░░░░░░░░░░░░░░░░░░░░░░░░░░░░░░░░░░░░░░░░░░░║       ║
                                                 ║       ╚══════════════════════════════════════════════════════════════════════════╝       ║
                                                 ║                                                                                          ║
                                                 ║                                                                                          ║
                                                 ╚══════════════════════════════════════════════════════════════════════════════════════════╝
",
      "init_pos": [11, 21],
      "exits": {},
      "items": {
          "Terminal 1": [11, 93],
          "Terminal 2": [33, 22],
          "Terminal 3": [11, 102]
          }
}