{
    "name": "Lata_Mukherjee",
    "raw": "▉▉▒▒▒▒▒▒▉▉▉▉▉▉▉▉▉▉▉▉▉▉▉▉▉▉▉▉▉▉▉▉    ʘ             ▎▎▎▎▎▎▎▎▎▎▎▎▉▉
▉▉▒▒▒▒▒▒▉▉▉▉▉▉▉▉▉▉▉▉▉▉▉▉▉▉▉▉▉▉▉▉                  ▎▎▎▎▎▎▎▎▎▎▎▎▉▉
▉▉▒▒▒▒▒▒▉▉▉▉▉▉▉▉▉▉▉▉▉▉▉▉▉▉▉▉▉▉▉▉                  ▎▎▎▎▎▎▎▎▎▎▎▎▉▉
▉▉▒▒▒▒▒▒                ▉▉▉▉▉▉▉▉                  ▎▎▎▎▎▎▎▎▎▎▎▎▉▉
▉▉▒▒▒▒▒▒                ▉▉▉▉▉▉▉▉                  ▎▎▎▎▎▎▎▎▎▎▎▎▉▉
▉▉▒▒▒▒▒▒                ▉▉▉▉▉▉▉▉                  ▎▎▎▎▎▎▎▎▎▎▎▎▉▉
▉▉▒▒▒▒▒▒                ▉▉▉▉▉▉▉▉                  ▎▎▎▎▎▎▎▎▎▎▎▎▉▉
▉▉▒▒▒▒▒▒                ▉▉▉▉▉▉▉▉                  ▎▎▎▎▎▎▎▎▎▎▎▎▉▉
▉▉▒▒▒▒▒▒                ▉▉▉▉▉▉▉▉                  ▟▟▟▟▟▟▟▟▟▟▟▟▉▉
▉▉▒▒▒▒▒▒                                          ▟▟▟▟▟▟▟▟▟▟▟▟▉▉
▉▉▒▒▒▒▒▒                                          ▟▟▟▟▟▟▟▟▟▟▟▟▉▉
▉▉▒▒▒▒▒▒                                          ▟▟▟▟▟▟▟▟▟▟▟▟▉▉
▉▉▒▒▒▒▒▒                  ▉▉▉▉▉▉▉▉                ▟▟▟▟▟▟▟▟▟▟▟▟▉▉
▉▉▒▒▒▒▒▒                  ▉▉▉▉▉▉▉▉                ▟▟▟▟▟▟▟▟▟▟▟▟▉▉
▉▉▒▒▒▒▒▒                  ▉▉▉▉▉▉▉▉                            ▉▉
▉▉▒▒▒▒▒▒                  ▉▉▉▉▉▉▉▉                      ▒▒▒▒▒▒▉▉
▉▉▒▒▒▒▒▒                  ▉▉▉▉▉▉▉▉                      ▒▒▒▒▒▒▉▉
▉▉▒▒▒▒▒▒                  ▉▉▉▉▉▉▉▉                      ▒▒▒▒▒▒▉▉
▉▉▒▒▒▒▒▒                  ▉▉▉▉▉▉▉▉                      ▒▒▒▒▒▒▉▉
▉▉▒▒▒▒▒▒                  ▉▉▉▉▉▉▉▉                      ▒▒▒▒▒▒▉▉
▉▉▒▒▒▒▒▒                  ▉▉▉▉▉▉▉▉                      ▒▒▒▒▒▒▉▉
▉▉▒▒▒▒▒▒                                                ▒▒▒▒▒▒▉▉
▉▉▒▒▒▒▒▒                                                ▒▒▒▒▒▒▉▉
▉▉▒▒▒▒▒▒                                                ▒▒▒▒▒▒▉▉
▉▉▒▒▒▒▒▒  ▂▂▂▂▂▂▂▂▂▂▂▂  ▂▂▂▂▂▂▂▂▂▂▂▂                    ▒▒▒▒▒▒▉▉
▉▉▒▒▒▒▒▒  ▂▂▂▂▂▂▂▂▂▂▂▂  ▂▂▂▂▂▂▂▂▂▂▂▂                    ▒▒▒▒▒▒▉▉
▉▉▒▒▒▒▒▒  ▂▂▂▂▂▂▂▂▂▂▂▂  ▂▂▂▂▂▂▂▂▂▂▂▂                    ▒▒▒▒▒▒▉▉
▉▉▒▒▒▒▒▒                                                ▒▒▒▒▒▒▉▉
▉▉▒▒▒▒▒▒▒▒▒▒▒▒▒▒▒▒▒▒▒▒▒▒▒▒▒▒▒▒▒▒▒▒▒▒▒▒▒▒▒▒▒▒            ▒▒▒▒▒▒▉▉
▉▉▒▒▒▒▒▒▒▒▒▒▒▒▒▒▒▒▒▒▒▒▒▒▒▒▒▒▒▒▒▒▒▒▒▒▒▒▒▒▒▒▒▒            ▒▒▒▒▒▒▉▉
▉▉▒▒▒▒▒▒▒▒▒▒▒▒▒▒▒▒▒▒▒▒▒▒▒▒▒▒▒▒▒▒▒▒▒▒▒▒▒▒▒▒▒▒            ▒▒▒▒▒▒▉▉
▉▉▉▉▉▉▉▉▉▉▉▉▉▉▉▉▉▉▉▉▉▉▉▉▉▉▉▉▉▉▉▉▉▉▉▉▉▉▉▉▉▉▉▉▉▉▉▉▉▉▉▉▉▉▉▉▉▉▉▉▉▉▉▉",
    "init_pos": [0,41],
    "exits": {"0,36" : ["SC",[48,63]]
},
    "items": {}
}