{
    "name": "Lata_Mukherjee",
    "raw": "▉▉▒▒▒▒▒▒▉▉▉▉▉▉▉▉▉▉▉▉▉▉▉▉▉▉▉▉▉▉▉▉↑ ↑ ↑ ↑ ↑ ↑ ↑ ↑ ↑ ▎▎▎▎▎▎▎▎▎▎▎▎▉▉
▉▉▒▒▒▒▒▒▉▉▉▉▉▉▉▉▉▉▉▉▉▉▉▉▉▉▉▉▉▉▉▉                  ▎▎▎▎▎▎▎▎▎▎▎▎▉▉
▉▉▒▒▒▒▒▒▉▉▉▉▉▉▉▉▉▉▉▉▉▉▉▉▉▉▉▉▉▉▉▉                  ▎▎▎▎▎▎▎▎▎▎▎▎▉▉
▉▉▒▒▒▒▒▒                ▉▉▉▉▉▉▉▉                  ▎▎▎▎▎▎▎▎▎▎▎▎▉▉
▉▉▒▒▒▒▒▒                ▉▉▉▉▉▉▉▉                  ▎▎▎▎▎▎▎▎▎▎▎▎▉▉
▉▉▒▒▒▒▒▒                ▉▉▉▉▉▉▉▉                  ▎▎▎▎▎▎▎▎▎▎▎▎▉▉
▉▉▒▒▒▒▒▒                ▉▉▉▉▉▉▉▉                  ▎▎▎▎▎▎▎▎▎▎▎▎▉▉
▉▉▒▒▒▒▒▒                ▉▉▉▉▉▉▉▉                  ▎▎▎▎▎▎▎▎▎▎▎▎▉▉
▉▉▒▒▒▒▒▒                ▉▉▉▉▉▉▉▉                  ▟▟▟▟▟▟▟▟▟▟▟▟▉▉
▉▉▒▒▒▒▒▒                                          ▟▟▟▟▟▟▟▟▟▟▟▟▉▉
▉▉▒▒▒▒▒▒                                          ▟▟▟▟▟▟▟▟▟▟▟▟▉▉
▉▉▒▒▒▒▒▒                                          ▟▟▟▟▟▟▟▟▟▟▟▟▉▉
▉▉▒▒▒▒▒▒                  ▉▉▉▉▉▉▉▉                ▟▟▟▟▟▟▟▟▟▟▟▟▉▉
▉▉▒▒▒▒▒▒                  ▉▉▉▉▉▉▉▉                ▟▟▟▟▟▟▟▟▟▟▟▟▉▉
▉▉▒▒▒▒▒▒                  ▉▉▉▉▉▉▉▉                            ▉▉
▉▉▒▒▒▒▒▒                  ▉▉▉▉▉▉▉▉                      ▒▒▒▒▒▒▉▉
▉▉▒▒▒▒▒▒                  ▉▉▉▉▉▉▉▉                      ▒▒▒▒▒▒▉▉
▉▉▒▒▒▒▒▒                  ▉▉▉▉▉▉▉▉                      ▒▒▒▒▒▒▉▉
▉▉▒▒▒▒▒▒                  ▉▉▉▉▉▉▉▉                      ▒▒▒▒▒▒▉▉
▉▉▒▒▒▒▒▒                  ▉▉▉▉▉▉▉▉                      ▒▒▒▒▒▒▉▉
▉▉▒▒▒▒▒▒                  ▉▉▉▉▉▉▉▉                      ▒▒▒▒▒▒▉▉
▉▉▒▒▒▒▒▒                                                ▒▒▒▒▒▒▉▉
▉▉▒▒▒▒▒▒                                                ▒▒▒▒▒▒▉▉
▉▉▒▒▒▒▒▒                                                ▒▒▒▒▒▒▉▉
▉▉▒▒▒▒▒▒  ▂▂▂▂▂▂▂▂▂▂▂▂  ▂▂▂▂▂▂▂▂▂▂▂▂                    ▒▒▒▒▒▒▉▉
▉▉▒▒▒▒▒▒  ▂▂▂▂▂▂▂▂▂▂▂▂  ▂▂▂▂▂▂▂▂▂▂▂▂                    ▒▒▒▒▒▒▉▉
▉▉▒▒▒▒▒▒  ▂▂▂▂▂▂▂▂▂▂▂▂  ▂▂▂▂▂▂▂▂▂▂▂▂                    ▒▒▒▒▒▒▉▉
▉▉▒▒▒▒▒▒                                                ▒▒▒▒▒▒▉▉
▉▉▒▒▒▒▒▒▒▒▒▒▒▒▒▒▒▒▒▒▒▒▒▒▒▒▒▒▒▒▒▒▒▒▒▒▒▒▒▒▒▒▒▒            ▒▒▒▒▒▒▉▉
▉▉▒▒▒▒▒▒▒▒▒▒▒▒▒▒▒▒▒▒▒▒▒▒▒▒▒▒▒▒▒▒▒▒▒▒▒▒▒▒▒▒▒▒            ▒▒▒▒▒▒▉▉
▉▉▒▒▒▒▒▒▒▒▒▒▒▒▒▒▒▒▒▒▒▒▒▒▒▒▒▒▒▒▒▒▒▒▒▒▒▒▒▒▒▒▒▒            ▒▒▒▒▒▒▉▉
▉▉▉▉▉▉▉▉▉▉▉▉▉▉▉▉▉▉▉▉▉▉▉▉▉▉▉▉▉▉▉▉▉▉▉▉▉▉▉▉▉▉▉▉▉▉▉▉▉▉▉▉▉▉▉▉▉▉▉▉▉▉▉▉",
    "init_pos": [3,41],
    "exits": {
		"0,32" : ["SC",[48,63]],
		"0,33" : ["SC",[48,63]],
		"0,34" : ["SC",[48,63]],
		"0,35" : ["SC",[48,63]],
		"0,36" : ["SC",[48,63]],
		"0,37" : ["SC",[48,63]],
		"0,38" : ["SC",[48,63]],
		"0,39" : ["SC",[48,63]],
		"0,40" : ["SC",[48,63]],
		"0,41" : ["SC",[48,63]],
		"0,42" : ["SC",[48,63]],
		"0,43" : ["SC",[48,63]],
		"0,44" : ["SC",[48,63]],
		"0,45" : ["SC",[48,63]],
		"0,46" : ["SC",[48,63]],
		"0,47" : ["SC",[48,63]],
		"0,48" : ["SC",[48,63]],
		"0,49" : ["SC",[48,63]]
},
    "items": {}
}