{
    "name": "Lata Mukherjee's Shop",
    "raw": "▉▉▒▒▒▒▒▒▉▉▉▉▉▉▉▉▉▉▉▉▉▉▉▉▉▉▉▉▉▉▉▉↑ ↑ ↑ ↑ ↑ ↑ ↑ ↑ ↑ ▎▎▎▎▎▎▎▎▎▎▎▎▉▉
▉▉▒▒▒▒▒▒▉▉▉▉▉▉▉▉▉▉▉▉▉▉▉▉▉▉▉▉▉▉▉▉                  ▎▎▎▎▎▎▎▎▎▎▎▎▉▉
▉▉▒▒▒▒▒▒▉▉▉▉▉▉▉▉▉▉▉▉▉▉▉▉▉▉▉▉▉▉▉▉                  ▎▎▎▎▎▎▎▎▎▎▎▎▉▉
▉▉▒▒▒▒▒▒                ▉▉▉▉▉▉▉▉                  ▎▎▎▎▎▎▎▎▎▎▎▎▉▉
▉▉▒▒▒▒▒▒                ▉▉▉▉▉▉▉▉                  ▎▎▎▎▎▎▎▎▎▎▎▎▉▉
▉▉▒▒▒▒▒▒                ▉▉▉▉▉▉▉▉                  ▎▎▎▎▎▎▎▎▎▎▎▎▉▉
▉▉▒▒▒▒▒▒                ▉▉▉▉▉▉▉▉                  ▎▎▎▎▎▎▎▎▎▎▎▎▉▉
▉▉▒▒▒▒▒▒                ▉▉▉▉▉▉▉▉                  ▎▎▎▎▎▎▎▎▎▎▎▎▉▉
▉▉▒▒▒▒▒▒                ▉▉▉▉▉▉▉▉                  ▟▟▟▟▟▟▟▟▟▟▟▟▉▉
▉▉▒▒▒▒▒▒                                          ▟▟▟▟▟▟▟▟▟▟▟▟▉▉
▉▉▒▒▒▒▒▒                                          ▟▟▟▟▟▟▟▟▟▟▟▟▉▉
▉▉▒▒▒▒▒▒                                          ▟▟▟▟▟▟▟▟▟▟▟▟▉▉
▉▉▒▒▒▒▒▒                  ▉▉▉▉▉▉▉▉                ▟▟▟▟▟▟▟▟▟▟▟▟▉▉
▉▉▒▒▒▒▒▒                  ▉▉▉▉▉▉▉▉                ▟▟▟▟▟▟▟▟▟▟▟▟▉▉
▉▉▒▒▒▒▒▒                  ▉▉▉▉▉▉▉▉                            ▉▉
▉▉▒▒▒▒▒▒                  ▉▉▉▉▉▉▉▉                      ▒▒▒▒▒▒▉▉
▉▉▒▒▒▒▒▒                  ▉▉▉▉▉▉▉▉                      ▒▒▒▒▒▒▉▉
▉▉▒▒▒▒▒▒                  ▉▉▉▉▉▉▉▉                      ▒▒▒▒▒▒▉▉
▉▉▒▒▒▒▒▒                  ▉▉▉▉▉▉▉▉                      ▒▒▒▒▒▒▉▉
▉▉▒▒▒▒▒▒                  ▉▉▉▉▉▉▉▉                      ▒▒▒▒▒▒▉▉
▉▉▒▒▒▒▒▒                  ▉▉▉▉▉▉▉▉                      ▒▒▒▒▒▒▉▉
▉▉▒▒▒▒▒▒                                                ▒▒▒▒▒▒▉▉
▉▉▒▒▒▒▒▒                                                ▒▒▒▒▒▒▉▉
▉▉▒▒▒▒▒▒                                                ▒▒▒▒▒▒▉▉
▉▉▒▒▒▒▒▒  ▂▂▂▂▂▂▂▂▂▂▂▂  ▂▂▂▂▂▂▂▂▂▂▂▂                    ▒▒▒▒▒▒▉▉
▉▉▒▒▒▒▒▒  ▂▂▂▂▂▂▂▂▂▂▂▂  ▂▂▂▂▂▂▂▂▂▂▂▂                    ▒▒▒▒▒▒▉▉
▉▉▒▒▒▒▒▒  ▂▂▂▂▂▂▂▂▂▂▂▂  ▂▂▂▂▂▂▂▂▂▂▂▂                    ▒▒▒▒▒▒▉▉
▉▉▒▒▒▒▒▒                                                ▒▒▒▒▒▒▉▉
▉▉▒▒▒▒▒▒▒▒▒▒▒▒▒▒▒▒▒▒▒▒▒▒▒▒▒▒▒▒▒▒▒▒▒▒▒▒▒▒▒▒▒▒            ▒▒▒▒▒▒▉▉
▉▉▒▒▒▒▒▒▒▒▒▒▒▒▒▒▒▒▒▒▒▒▒▒▒▒▒▒▒▒▒▒▒▒▒▒▒▒▒▒▒▒▒▒            ▒▒▒▒▒▒▉▉
▉▉▒▒▒▒▒▒▒▒▒▒▒▒▒▒▒▒▒▒▒▒▒▒▒▒▒▒▒▒▒▒▒▒▒▒▒▒▒▒▒▒▒▒            ▒▒▒▒▒▒▉▉
▉▉▉▉▉▉▉▉▉▉▉▉▉▉▉▉▉▉▉▉▉▉▉▉▉▉▉▉▉▉▉▉▉▉▉▉▉▉▉▉▉▉▉▉▉▉▉▉▉▉▉▉▉▉▉▉▉▉▉▉▉▉▉▉",
    "init_pos": [3,41],
    "exits": {
		"0,32" : ["SC",[47,62]],
		"0,33" : ["SC",[47,62]],
		"0,34" : ["SC",[47,62]],
		"0,35" : ["SC",[47,63]],
		"0,36" : ["SC",[47,63]],
		"0,37" : ["SC",[47,63]],
		"0,38" : ["SC",[47,64]],
		"0,39" : ["SC",[47,64]],
		"0,40" : ["SC",[47,64]],
		"0,41" : ["SC",[47,65]],
		"0,42" : ["SC",[47,65]],
		"0,43" : ["SC",[47,65]],
		"0,44" : ["SC",[47,66]],
		"0,45" : ["SC",[47,66]],
		"0,46" : ["SC",[47,66]],
		"0,47" : ["SC",[47,67]],
		"0,48" : ["SC",[47,67]],
		"0,49" : ["SC",[47,67]]
    },
    "items": {
        "Pay": [5, 32],
        "Tender": [17, 34],
		"Biswas PhD": [16,47],
		"Shelf1": [15, 55],
		"Shelf2": [25, 55],
		"Shelf3": [27, 17],
		"Shelf4": [14, 8],
		"Shelf5": [10, 8]
    },
    "items_on_startup": ["Tender"]
}
