{
    "name": "LHC",
    "raw": "░░░░░░░░░░░░░░░░░░░░░░░░░░░░░░░░░░░░░░░░░░░↑ ↑ ↑ ↑ ↑ ↑ ░░░░░░░░░░░░░░░░░░░░░░░░░░░░░░░░░░░░░░░░░░░░░░░░░░░░░░░░░░░░░░░░░░░░░░░░░░░░░░░░░░░░░░░░░░░░░░░░░░░░░░░░░░░░░░▉▉▉▉▉▉▉▉▉▉▉▉▉▉▉▉▉▉▉░░░░░░░░░░░░░░░░
░░░░░░░░░░░░░░░░░░░░░░░░░░░░░░░░░░░░░░░░░░░            ░░░░░░░░░░░░░░░░░░░░░░░░░░░░░░░░░░░░░░░░░░░░░░░░░░░░░░░░░░░░░░░░░░░░░░░░░░░░░░░░░░░░░░░░░░░░░░░░░░░░░░░░░░░░░░                   ░░░░░░░░░░░░░░░░
░░░░░░░░░░░░░░░░░░░░░░░░░░░░░░░░░░░░░░░░░░░            ░░░░░░░░░░░░░░░░░░░░░░░░░░░░░░░░░░░░░░░░░░░░░░░░░░░░░░░░░░░░░░░░░░░░░░░░░░░░░░░░░░░░░░░░░░░░░░░░░░░░░░░░░░░░░░                   ░░░░░░░░░░░░░░░░
░░░░░░░░░░░░░░░░░░░░░░░░░░░░░░░░░░░░░░░░░░░            ░░░░░░░░░░░░░░░░░░░░░░░░░▉▉▉▉▉▉▉▉▉▉▉▉▉▉▉░░░░░░░░░░░░░░░░░░░░░░░░░░░░░░░░░░░░░░░░░░░░░░░░░░░░░░░░░░░░░░░░░░░░░░                   ░░░░░░░░░░░░░░░░
░░░░░░░░░░░░░░░░░░░░░░░░░░░░░░░░░░░░░░░░░░░            ░░░░░░░░░░░░░░░░░░░░░░░░░▉▉▉▉▉▉▉▉▉▉▉▉▉▉▉░░░░░░░░░░░░░░░░░░░░░░░░░░░░░░░░░░░░░░░░░░░░░░░░░░░░░░░░░░░░░░░░░░░░░░                   ░░░░░░░░░░░░░░░░
░░░░░░░░░░░░░░░░░░░░░░░░░░░░░░░░░░░░░░░░░░░            ░░░░░░░░░░░░░░░░░░░░░░░░░▉▉▉▉▉▉▉▉▉▉▉▉▉▉▉░░░░░░░░░░░░░░░░░░░░░░░░░░░░░░░░░░░░░░░░░░░░░░░░░░░░░░░░░░░░░░░░░░░░░░                   ░░░░░░░░░░░░░░░░
░░░░░░░░░░░░░░░░░░░░░░░░░░░░░░░░░░░░░░░░░░░            ░░░░░░░░░░░░░░░░░░░▉▉▉▉▉▉▉▉▉▉▉▉▉▉▉▉▉▉▉▉▉░░░░░░░░▉▉▉▉▉▉▉▉▉░░░░░░░░░░░░░░░░░░░░▉▉▉▉▉▉░░░░░░░░░░░░░░░░░░░░░░░░░░░                   ░░░░░░░░░░░░░░░░
░░░░░░░░░░░░░░░░░░░░░░░░░░░░░░░░░░░░░░░░░░░            ░░░░░░░░░░░░░░░░░░░▉▉▉▉▉▉▉▉▉▉▉▉▉▉▉▉▉▉▉▉▉░░░░░░░░▉▉▉▉▉▉▉▉▉░░░░░░░░░░░░░░░░░░░░▉▉▉▉▉▉░░░░░░░░░░░░░░░░░░░░░░░░░░░                   ░░░░░░░░░░░░░░░░
░░░░░░░░░░░░░░░░░░░░░░░░░░░░░░░░░░░░░░░░░░░            ░░░░░░░░░░░░░░░░░░░▉▉▉▉▉▉▉▉▉▉▉▉▉▉▉▉▉▉▉▉▉▉▉▉▉▉▉▉▉▉▉▉▉▉▉▉▉▉░░░░░░░░░░░░░░░░░░░░▉▉▉▉▉▉░░░░░░░░░░░░░░░░░░░░░░░░░░░                   ░░░░░░░░░░░░░░░░
░░░░░░░░░░░░░░░░░░░░░░░░░░░░░░░░░░░░░░░░░░░            ░░░░░░░░░░░░░░░░░░░▉▉▉▉▉▉▉▉▉▉▉▉▉▉▉▉▉▉▉▉▉▉▉▉▉▉▉▉▉▉▉▉▉▉▉▉▉▉▉▉▉▉▉▉▉▉▉▉▉▉▉▉▉▉░░░░▉▉▉▉▉▉░░░░░░░░░░░░░░░░░░░░░░░░░░░                   ░░░░░░░░░░░░░░░░
░░░░░░░░░░░░░░░░░░░░░░░░░░░░░░░░░░░░░░░░░░░            ░░░░░░░░░░░░░░░░░░░▉▉▉▉▉▉▉▉▉▉▉▉▉▉▉▉▉▉▉▉▉▉▉▉▉▉▉▉▉▉▉▉▉▉▉▉▉▉▉▉▉▉▉▉▉▉▉▉▉▉▉▉▉▉▉▉▉▉▉▉▉▉▉▉▉▉▉▉▉▉░░░░░░░░░░░░░░░░░░░░░                   ░░░░░░░░░░░░░░░░
░░░░░░░░░░░░░░░░░░░░░░░░░░░░░░░░░░░░░░░░░░░            ░░░░░░░░░░░░░░░░░░░▉▉▉▉▉▉▉▉▉▉▉▉▉▉▉▉▉▉▉▉▉▉▉▉▉▉▉▉▉▉▉▉▉▉▉▉▉▉▉▉▉▉▉▉▉▉▉▉▉▉▉▉▉▉▉▉▉▉▉▉▉▉▉▉▉▉▉▉▉▉░░░░░░░░░░░░░░░░░░░░░                   ░░░░░░░░░░░░░░░░
░░░░░░░░░░░░░░░░░░░░░░░░░░░░░░░░░░░░░░░░░░░            ░░░░░░░░░░░░░░░░░░░▉▉▉▉▉▉▉▉▉▉▉*******▉▉▉▉*************▉▉▉▉▉▉▉▉▉▉▉▉▉▉▉▉▉▉▉▉▉▉▉▉▉▉▉▉▉▉▉▉▉▉▉░░░░░░░░░░░░░░░░░░░░░                   ░░░░░░░░░░░░░░░░
░░░░░░░░░░░░░░░░░░░░░░░░░░░░░░░░░░░░░░░░░░░            ░░░░░░░░░░░░░░░░░░░▉▉▉▉▉▉▉▉▉▉▉*******▉▉▉▉*************▉▉▉▉▉▉▉▉▉▉▉▉▉▉▉▉▉▉▉▉▉▉▉▉▉▉▉▉▉▉▉▉▉▉▉░░░░░░░░░░░░░░░░░░░░░                   ░░░░░░░░░░░░░░░░
░░░░░░░░░░░░░░░░░░░░░░░░░░░░░░░░░░░░░░░░░░░            ░░░░░░░░░░░░░░░░░░░▉▉▉▉▉*************▉▉▉▉*************▉▉**********************▉░░░░░░░░░░░░░░░░░░░░░░░░░░░░░░░                   ░░░░░░░░░░░░░░░░
░░░░░░░░░░░░░░░░░░░░░░░░░░░░░░░░░░░░░░░░░░             ░░░░░░░░░░░░░░░░░░░▉▉▉▉▉*************▉▉▉▉*************▉▉**********************▉░░░░░░░░░░░░░░░░░░░░░░░░░░░░░░░                   ░░░░░░░░░░░░░░░░
░░░░░░░░░░░░░░░░░░░░░░░░░░░░░░░░░░░░░░░░░              ░░░░░░░░░░░░░░░░░░░▉▉▉▉▉*************▉▉▉▉*************▉▉**********************▉░░░░░░░░░░░░░░░░░░░░░░░░░░░░░░░                   ░░░░░░░░░░░░░░░░
░░░░░░░░░░░░░░░░░░░░░░░░░░░░░░░░░░░░░░░░               ░░░░░░░░░░░░░░░░░░░▉▉▉▉▉*************▉▉▉▉*************▉▉**********************▉░░░░░░░░░░░░░░░░░░░░░░░░░░░░░░░                   ░░░░░░░░░░░░░░░░
░░░░░░░░░░░░░░░░░░░░░░░░░░░░░░░░░░░░░░░                ░░░░░░░░░▉▉▉▉▉▉▉▉▉▉▉▉▉▉▉▉▉▉▉▉▉▉▉▉▉▉▉▉▉▉▉▉*************▉▉**********************▉░░░░░░░░░░░░░░░░░░░░░░░░░░░░░░░                   ░░░░░░░░░░░░░░░░
░░░░░░░░░░░░░░░░░░░░░░░░░░░░░░░░░░░░░░                 ░░░░░░░░░▉▉▉▉▉▉▉▉▉▉▉▉▉▉▉▉▉▉▉▉▉▉▉▉▉▉▉▉▉▉▉▉▉▉▉▉▉▉▉▉▉▉▉▉▉▉▉**********************▉░░░░░░░░░░░░░░░░░░░░░░░░░░░░░░░                   ░░░░░░░░░░░░░░░░
░░░░░░░░░░░░░░░░░░░░░░░░░░░░░░░░░░░░░                           ▉▉▉▉▉▉▉▉▉▉▉▉▉▉▉▉▉▉▉▉▉▉▉▉▉▉▉▉▉▉▉▉▉▉▉▉▉▉▉▉▉▉▉▉▉▉▉**********************▉░░░░░░░░░░░░░░░░░░░░░░░░░░░░░░░                   ░░░░░░░░░░░░░░░░
░░░░░░░░░░░░░░░░░░░░░░░░░░░░░░░░░░░░                            ▉▉▉▉▉▉▉▉▉▉▉▉▉▉▉▉▉▉▉▉▉▉▉▉▉▉▉▉▉▉*************▉▉▉▉**********************▉░░░░░░░░░░░░░░░░░░░░░░░░░░░░░░░                   ░░░░░░░░░░░░░░░░
░░░░░░░░░░░░░░░░░░░░░░░░░░░░░░░░░░░                             ▉▉▉▉▉▉▉▉▉▉▉▉▉▉▉▉▉▉▉▉▉▉▉▉▉▉▉▉▉▉▉▉▉▉▉▉▉▉▉▉▉▉▉▉▉▉▉▉▉▉▉▉▉▉▉▉▉▉▉▉▉▉▉▉▉▉▉▉▉▉░░░░░░░░░░░░░░░░░░░░░░░░░░░░░░░                   ░░░░░░░░░░░░░░░░
░░░░░░░░░░░░░░░░░░░░░░░░░░░░░░░░░░                              ▉▉▉▉▉▉▉▉▉▉▉▉▉▉▉▉▉▉▉▉▉▉▉▉▉▉▉▉▉▉▉▉▉▉▉▉▉▉▉▉▉▉▉▉▉▉▉▉▉▉▉▉▉▉▉▉▉▉▉▉▉▉▉▉▉▉▉▉▉▉░░░░░░░░░░░░░░░░░░░░░░░░░░░░░░░                   ░░░░░░░░░░░░░░░░
░░░░░░░░░░░░░░░░░░░░░░░░░░░░░░░░░                               ▉▉▉▉▉▉▉▉▉▉▉▉▉▉▉▉▉▉▉▉▉▉▉▉▉▉▉▉▉▉*************▉▉▉▉▉▉▉▉▉▉▉▉▉▉▉▉▉▉▉▉▉▉▉▉▉▉▉░░░░░░░░░░░░░░░░░░░░░░░░░░░░░░░                   ░░░░░░░░░░░░░░░░
░░░░░░░░░░░░░░░░░░░░░░░░░░░░░░░░                                ▉▉▉▉▉▉▉▉▉▉▉▉▉▉▉▉▉▉▉▉▉▉▉▉▉▉▉▉▉▉▉▉▉▉▉▉▉▉▉▉▉▉▉▉▉▉▉▉▉▉▉▉▉▉▉▉▉▉▉▉▉▉▉▉▉▉▉▉▉▉░░░░░░░░░░░░░░░░░░░░░░░░░░░░░░░                   ░░░░░░░░░░░░░░░░
░░░░░░░░░░░░░░░░░░░░░░░░░░░░░░░                                 ▉▉▉▉▉▉▉▉▉▉▉▉▉▉▉▉▉▉▉▉▉▉▉▉▉▉▉▉*************▉▉▉▉▉▉▉░░░░▉▉▉▉▉▉▉▉▉▉▉▉▉▉▉▉▉▉░░░░░░░░░░░░░░░░░░░░░░░░░░░░░░░                   ░░░░░░░░░░░░░░░░
░░░░░░░░░░░░░░░░░░░░░░░░░░░░░░                                  ▉▉▉▉▉▉▉▉▉▉▉▉▉▉▉▉▉▉▉▉▉▉▉▉▉▉▉▉▉▉▉▉▉▉▉▉▉▉▉▉▉▉▉▉▉▉▉▉░░░░▉▉▉▉▉▉▉▉▉▉▉▉░░░░░░░░░░░░░░░░░░░░░░░░░░░░░░░░░░░░░                   ░░░░░░░░░░░░░░░░
░░░░░░░░░░░░░░░░░░░░░░░░░░░░░                                   ▉▉▉▉▉▉▉▉▉▉▉▉▉▉▉▉▉▉▉▉▉▉▉▉▉▉▉▉▉▉**************▉▉▉▉░░░░▉▉▉▉▉▉▉▉▉▉▉▉░░░░░░░░░░░░░░░░░░░░░░░░░░░░░░░░░░░░░                   ░░░░░░░░░░░░░░░░
░░░░░░░░░░░░░░░░░░░░░░░░░░░░                           ░░░░░░░░░▉▉▉▉▉▉▉▉▉▉▉▉▉▉▉▉▉▉▉▉▉▉▉▉▉▉▉▉▉▉▉▉▉▉▉▉▉▉▉▉▉▉▉▉▉▉▉▉░░░░▉▉▉▉▉▉▉▉▉▉▉▉░░░░░░░░░░░░░░░░░░░░░░░░░░░░░░░░░░░░░                   ░░░░░░░░░░░░░░░░
░░░░░░░░░░░░░░░░░░░░░░░░░░░                           ░░░░░░░░░░░░░░░▉▉▉▉▉▉▉▉▉▉▉▉▉▉▉▉▉▉▉▉▉▉▉▉▉**************▉▉▉▉░░░░▉▉▉▉▉▉▉▉▉▉▉▉░░░░░░░░░░░░░░░░░░░░░░░░░░░░░░░░░░░░░                   ░░░░░░░░░░░░░░░░
░░░░░░░░░░░░░░░░░░░░░░░░░░                           ░░░░░░░░░░░░░░░░▉▉▉▉▉▉▉▉▉▉▉▉▉▉░░░░▉▉▉▉▉▉▉▉▉▉▉▉▉▉▉▉▉▉▉▉▉▉░░░░░░░▉▉▉▉▉▉▉▉▉▉▉▉░░░░░░░░░░░░░░░░░░░░                                    ░░░░░░░░░░░░░░░░
←                                                   ░░░░░░░░░░░░░░░░░░░░░░░▉▉▉▉▉▉▉▉░░░░▉▉▉▉▉▉▉▉▉▉▉▉▉▉▉▉▉▉▉▉▉▉░░░░░░░▉▉▉▉▉▉▉▉▉▉▉▉░░░░░░░░░░░░░░░░░░░░                                    ░░░░░░░░░░░░░░░░
                                                   ░░░░░░░░░░░░░░░░░░░░░░░░░░░░░░░░░░░░░░░░░░░░░░░░░░░░░░░░░░░░░░░░░▉▉▉▉▉▉▉▉▉▉▉▉░░░░░░░░░░░░░░░░░░░░                                    ░░░░░░░░░░░░░░░░
←                                                 ░░░░░░░░░░░░░░░░░░░░░░░░░░░░░░░░░░░░░░░░░░░░░░░░░░░░░░░░░░░░░░░░░░░░░░░░░░░░░░░░░░░░░░░░░░░░░░░░░░                                             ░░░░░░░
                                                 ░░░░░░░░░░░░░░░░░░░░░░░░░░░░░░░░░░░░░░░░░░░░░░░░░░░░░░░░░░░░░░░░░░░░░░░░░░░░░░░░░░░░░░░░░░░░░░░░░░░                                             ░░░░░░░
←                                               ░░░░░░░░░░░░░░░░░░░░░░░░░░░░░░░░░░░░░░░░░░░░░░░░░░░░░░░░░░░░░░░░░░░░░░░░░░░░░░░░░░░░░░░░░░░░░░░░░░░░                                             ░░░░░░░
                                               ░░░░░░░░░░░░░░░░░░░░░░░░░░░░░░░░░░░░░░░░░░░░░░░░░░░░░░░░░░░░░░░░░░░░░░░░░░░░░░░░░░░░░░░░░░░░░░░░░░░░░                                             ░░░░░░░
←                                             ░░░░░░░░░░░░░░░░░░░░░░░░░░░░░░░░░░░░░░░░░░░░░░░░░░░░░░░░░░░░░░░░░░░░░░░░░░░░░░░░░░░░░░░░░░▉▉▉▉▉░░░░░░░                                             ░░░░░░░
                                             ░░░░░░░░░░░░░░░░░░░░░░░░░░░░░░░░░░░░░░░░░░░░░░░░░░░░░░░░░░░░░░░░░░░░░░░░░░▉▉▉▉▉▉▉▉▉▉▉▉▉▉▉░░▉▉▉▉▉░▉▉▉▉▉▉▉▉▉                                          ░░░░░░░
←                                             ░░░░░░░░▉▉▉▉▉▉▉▉▉▉▉▉▉▉▉▉▉▉▉▉▉▉▉▉▉▉▉░░░░░░░░░░░░░░░░░░░░░░░░░░░░░░░░░░░░░░▉▉▉▉▉▉▉▉▉▉▉▉▉▉▉░░▉▉▉▉▉░▉▉▉▉▉▉▉▉▉                                          ░░░░░░░
░░░░░░░░░░░░░░░░░░░░░░░░░░░░                   ░░░░░░░▉▉▉▉▉▉▉▉▉▉▉▉▉▉▉▉▉▉▉▉▉▉▉▉▉▉▉░░░░░░░░░░░░░░░░░░░░░░░░░░░░░░░░░▉▉▉▉▉▉▉▉▉▉▉▉▉▉▉▉▉▉▉▉▉▉▉▉▉▉▉░▉▉▉▉▉▉▉▉▉                                          ░░░░░░░
░░░░░░░░░░░░░░░░░░░░░░░░░░░░░                   ░░░░░░▉▉▉▉▉▉▉▉▉▉▉▉▉▉▉▉▉▉▉▉▉▉▉▉▉▉▉▉▉▉▉▉▉▉▉▉▉▉▉▉▉░░░░░░░░░░░░░░░░░░░▉▉▉▉▉▉▉▉▉▉▉▉▉▉▉▉▉▉▉▉▉▉▉▉▉▉▉░▉▉▉▉▉▉▉▉▉                                          ░░░░░░░
░░░░░░░░░░░░░░░░░░░░░░░░░░░░░░                  ▉▉▉▉▉▉▉▉▉▉▉▉▉▉▉▉▉▉▉▉▉▉▉▉▉▉▉▉▉▉▉▉▉▉▉▉▉▉▉▉▉▉▉▉▉▉▉░░░░░░░░░░░░░░░░░░░▉▉▉▉▉▉▉▉▉▉▉▉▉▉▉▉▉▉▉▉▉▉▉▉▉▉▉▉▉▉▉▉▉▉▉▉▉                                          ░░░░░░░
░░░░░░░░░░░░░░░░░░░░░░░░░░░░░░░                 ▉▉▉▉▉▉▉▉▉▉▉▉▉▉▉▉▉▉▉▉▉▉▉▉▉▉▉▉▉▉▉▉▉▉▉▉▉▉▉▉▉▉▉▉▉▉▉░░░░░░░░░░░░░░░░░░░▉▉▉▉▉▉▉▉▉▉▉▉▉▉▉▉▉▉▉▉▉▉▉▉▉▉▉▉▉▉▉▉▉▉▉▉▉                                          ░░░░░░░
░░░░░░░░░░░░░░░░░░░░░░░░░░░░░░░░              ▉▉▉▉▉▉▉▉▉▉▉********▉▉▉▉▉▉▉▉▉▉▉▉▉▉▉▉▉▉▉▉▉▉▉▉▉▉▉▉▉▉░░░░░░░░░░░░░░░░░░░▉▉▉▉▉▉▉▉▉▉▉▉▉▉▉▉▉▉▉▉▉▉▉▉▉▉▉▉▉▉▉▉▉▉▉▉▉                                          ░░░░░░░
░░░░░░░░░░░░░░░░░░░░░░░░░░░░░░░░░            ▉▉▉▉▉▉▉▉▉▉▉▉********▉▉▉▉▉▉▉▉▉▉▉▉▉▉▉▉▉▉▉▉▉▉▉▉▉▉▉▉▉▉░░░░░░░░░░░░░░░░░░░▉▉▉▉▉▉▉▉▉▉▉▉▉▉▉▉▉▉▉▉▉▉▉▉▉▉▉▉▉▉▉▉▉▉▉▉▉                                                →
░░░░░░░░░░░░░░░░░░░░░░░░░░░░░░░░░░         ▉▉▉▉▉▉▉*******************************▉▉▉▉▉▉▉▉▉▉▉▉▉▉░░░░░░░░░░░░░░░░░░░▉▉▉▉▉▉▉▉▉▉▉▉▉▉▉▉▉▉▉▉▉▉▉▉▉▉▉▉▉▉▉▉▉▉▉▉▉                                                →
░░░░░░░░░░░░░░░░░░░░░░░░░░░░░░░░░░░      ▉▉▉▉▉▉▉▉▉*******************************▉▉▉▉▉▉▉▉▉▉▉▉▉▉░░░░░░░░░░░░░░░░░░░▉▉▉▉▉▉▉▉▉▉▉▉▉▉▉▉▉▉▉▉▉▉▉▉▉▉▉▉▉▉▉▉▉▉▉▉▉                                                →
░░░░░░░░░░░░░░░░░░░░░░░░░░░░░░░░░░░░   ▉▉▉▉▉▉▉▉▉▉▉***********▉▉▉▉▉***************▉▉▉▉▉▉▉▉▉▉▉▉▉▉░░░░░░░░░░░░░░░░░░░▉▉▉▉▉▉▉▉░░░░░░▉▉▉▉▉▉▉▉▉▉▉▉▉▉▉▉▉▉▉▉▉▉▉                                          ░░░░░░░
░░░░░░░░░░░░░░░░░░░░░░░░░░░░░░░░░░░░░░▉▉▉▉▉▉▉▉▉▉▉▉*******▉▉▉▉▉***▉▉▉▉▉▉▉▉▉▉******▉▉▉▉▉▉▉▉▉▉▉▉▉▉░░░░░░░░░░░░░░░░░░░░░░░░░░░░░▉▉▉▉▉▉▉▉▉▉▉▉**************▉                                          ░░░░░░░
░░░░░░░░░░░░░░░░░░░░░░░░░░░░░░░░░░░░░░░░▉▉▉▉▉▉▉▉▉▉*******▉***▉***▉********▉******▉▉▉▉▉▉▉▉▉▉▉▉▉▉░░░░░░░░░░░░░░░░░░░░░░░░░░░░░▉▉▉▉▉▉▉▉▉▉▉▉**************▉                                          ░░░░░░░
░░░░░░░░░░░░░░░░░░░░░░░░░░░░░░░░░░░░░░░░░░░░░░░▉▉▉*******▉***▉***▉********▉▉▉▉*******▉▉▉▉▉▉▉▉▉▉░░░░░░░░░░░░░░░░░░░░░░░░░░░░░▉▉▉▉▉▉▉▉▉▉▉▉**************▉                                          ░░░░░░░
░░░░░░░░░░░░░░░░░░░░░░░░░░░░░░░░░░░░░░░░░░░░░░░▉▉▉*******▉***▉***▉▉▉▉▉▉▉▉▉▉**▉******▉▉▉▉▉▉▉▉▉▉▉░░░░░░░░░░░░░░░░░░░░░░░░░░░░░▉▉▉▉▉▉▉▉▉▉▉▉**************▉                                          ░░░░░░░
░░░░░░░░░░░░░░░░░░░░░░░░░░░░░░░░░░░░░░░░░░░░░░░▉▉▉*******▉▉▉▉▉***************▉******▉▉▉▉▉▉▉▉▉▉▉░░░░░░░░░░░░░░░░░░░░░░░░░░░░░▉▉▉▉▉▉▉▉▉▉▉▉**************▉                                          ░░░░░░░
░░░░░░░░░░░░░░░░░░░░░░░░░░░░░░░░░░░░░░░░░░░░░░░▉▉▉***********▉***************▉******▉▉▉▉▉▉▉▉▉▉▉░░░░░░░░░░░░░░░░░░░░░░░░░░░░░▉▉▉▉▉▉▉▉▉▉▉▉**************▉                                          ░░░░░░░
░░░░░░░░░░░░░░░░░░░░░░░░░░░░░░░░░░░░░░░░░░░░░░░▉▉▉***********▉***************▉******▉▉▉▉▉▉▉▉▉▉▉░░░░░░░░░░░░░░░░░░░░░░░░░░░░░▉▉▉▉▉▉▉▉▉▉▉▉**************▉                                          ░░░░░░░
░░░░░░░░░░░░░░░░░░░░░░░░░░░░░░░░░░▉▉▉▉▉▉▉▉▉▉▉▉▉▉▉▉▉▉▉▉▉▉▉****▉▉▉▉▉▉▉▉▉▉▉▉▉▉▉▉▉******▉▉▉▉▉▉▉▉▉▉▉░░░░░░░░░░░░░░░░░░░░░░░░░░▉▉▉▉▉▉▉▉▉▉▉▉▉▉▉**************▉                                          ░░░░░░░
░░░░░░░░░░░░░░░░░░░░░░░░░░░░░░░░░░▉▉▉▉▉▉▉▉▉▉▉▉▉▉▉▉▉▉▉▉▉▉▉****************************▉▉▉▉▉▉▉▉▉▉░░░░░░░░░░░░░░░░░░░░░░░░░░▉▉▉▉▉▉▉▉*********************▉                                          ░░░░░░░
░░░░░░░░░░░░░░░░░░░░░░░░░░░░░░░░░░▉▉▉▉▉▉▉▉▉▉▉▉▉▉▉▉▉▉▉▉▉▉▉▉▉▉▉▉▉▉▉▉▉▉▉▉▉▉▉▉▉▉▉▉▉▉▉▉▉▉▉▉▉▉▉▉▉▉▉▉▉░░░░░░░░░░░░░░░░░░░▉▉▉▉▉▉▉▉▉▉▉▉▉▉▉************▉▉▉▉▉▉▉▉▉▉                                          ░░░░░░░
░░░░░░░░░░░░░░░░░░░░░░░░░░░░░░░░░░▉▉▉▉▉▉▉▉▉▉▉▉▉▉▉▉▉▉▉▉▉▉▉▉▉▉▉▉▉▉▉▉▉▉▉▉▉▉▉▉▉▉▉▉▉▉▉▉▉▉▉▉▉▉▉▉▉▉▉▉▉░░░░░░░░░░░░░░░░░░░▉▉▉▉▉▉▉▉▉▉▉▉▉▉▉************▉▉▉▉▉▉▉▉▉▉             ░░░░░░░░░░░░░░░░             ░░░░░░░
░░░░░░░░░░░░░░░░░░░░░░░░░░░░░░░░░░░░░░░░░▉▉▉▉▉▉▉▉▉▉▉▉▉▉▉▉▉▉▉▉▉▉▉▉▉▉▉▉▉▉▉▉▉▉▉▉▉▉▉▉▉▉▉▉░░░░░░░░░░░░░░░░░░░░░░░░░░░░░▉▉▉▉▉▉▉▉▉▉▉▉▉▉▉************▉▉▉▉▉▉▉▉▉▉             ░░░░░░░░░░░░░░░░             ░░░░░░░
░░░░░░░░░░░░░░░░░░░░░░░░░░░░░░░░░░░░░░░░░▉▉▉▉▉▉▉▉▉▉▉▉▉▉▉▉▉▉▉▉▉▉▉▉▉▉▉▉▉▉▉▉▉▉▉▉▉▉▉▉▉▉▉▉░░░░░░░░░░░░░░░░░░░░░░░░░░░░░▉▉▉▉▉▉▉▉▉▉▉▉▉▉▉************▉▉▉▉▉▉▉▉▉▉             ░░░░░░░░░░░░░░░░             ░░░░░░░
░░░░░░░░░░░░░░░░░░░░░░░░░░░░░░░░░░░░░░░░░▉▉▉▉▉▉▉▉▉▉▉▉▉▉▉▉▉▉▉▉▉▉▉▉▉▉▉▉▉▉▉▉▉▉▉▉▉▉▉▉▉▉▉▉░░░░░░░░░░░░░░░░░░░░░░░░░░░░░▉▉▉▉▉▉▉▉▉▉▉▉▉▉▉************▉▉▉▉▉▉▉▉▉▉             ░░░░░░░░░░░░░░░░             ░░░░░░░
░░░░░░░░░░░░░░░░░░░░░░░░░░░░░░░░░░░░░░░░░▉▉▉▉▉▉▉▉▉▉▉▉▉▉▉▉▉▉▉▉▉▉▉▉▉▉▉▉▉▉▉▉▉▉▉▉▉▉▉▉░░░░░░░░░░░░░░░░░░░░░░░░░░░░░░░░░▉▉▉▉▉▉▉▉▉▉▉▉▉▉▉▉▉▉▉▉▉▉▉▉▉▉▉▉▉▉▉▉▉▉▉▉▉             ░░░░░░░░░░░░░░░░             ░░░░░░░
░░░░░░░░░░░░░░░░░░░░░░░░░░░░░░░░░░░░░░░░░▉▉▉▉▉▉▉▉▉▉▉▉▉▉▉▉▉▉▉▉▉▉▉▉▉▉▉▉▉▉▉▉▉▉▉▉▉▉▉▉░░░░░░░░░░░░░░░░░░░░░░░░░░░░░░░░░▉▉▉▉▉▉▉▉▉▉▉▉▉▉▉▉▉▉▉▉▉▉▉▉▉▉▉▉▉▉▉▉▉▉▉▉▉             ░░░░░░░░░░░░░░░░             ░░░░░░░
░░░░░░░░░░░░░░░░░░░░░░░░░░░░░░░░░░░░░░░░░▉▉▉▉▉▉▉▉▉▉▉▉▉▉▉▉▉▉▉▉▉▉▉▉▉▉▉▉▉▉▉▉▉▉▉▉▉▉▉▉░░░░░░░░░░░░░░░░░░░░░░░░░░░░░░░░░▉▉▉▉▉▉▉▉▉▉▉▉▉▉▉▉▉▉▉▉▉▉▉▉▉▉▉▉▉▉▉▉▉▉▉▉▉             ░░░░░░░░░░░░░░░░             ░░░░░░░
░░░░░░░░░░░░░░░░░░░░░░░░░░░░░░░░░░░░░░░░░░░░░░░░░░░░░░▉▉▉▉▉▉▉▉▉▉       ▉▉▉▉▉▉░░░░░░░░░░░░░░░░░░░░░░░░░░░░░░░░░░░░░▉▉▉▉▉▉▉▉▉▉▉▉▉▉▉▉▉▉▉▉▉▉▉▉▉▉▉▉▉▉▉▉▉▉▉▉▉             ░░░░░░░░░░░░░░░░             ░░░░░░░
←                                                     ▉▉▉▉▉▉▉▉▉▉       ▉▉▉▉▉▉                                          ▉▉▉▉▉▉▉▉▉▉▉▉▉▉▉▉▉▉▉▉▉▉▉▉▉▉▉▉▉▉▉▉             ░░░░░░░░░░░░░░░░             ░░░░░░░
←                                                     ▉▉▉▉▉▉▉▉▉▉       ▉▉▉▉▉▉                                          ▉▉▉▉▉▉▉▉▉▉▉▉▉▉▉▉▉▉▉▉▉▉▉▉▉▉▉▉▉▉▉▉             ░░░░░░░░░░░░░░░░             ░░░░░░░
                                                                                                                                                                    ░░░░░░░░░░░░░░░░             ░░░░░░░
←                                                                                                                                                                   ░░░░░░░░░░░░░░░░             ░░░░░░░
←                                                                                                                                                                   ░░░░░░░░░░░░░░░░             ░░░░░░░
←                                                                                                                                                                   ░░░░░░░░░░░░░░░░             ░░░░░░░
←                                                                                                                                                                   ░░░░░░░░░░░░░░░░             ░░░░░░░
                                                                                                                                                                    ░░░░░░░░░░░░░░░░             ░░░░░░░
←                                                                                                                                                                   ░░░░░░░░░░░░░░░░             ░░░░░░░
←                                                                                                                                                                   ░░░░░░░░░░░░░░░░             ░░░░░░░
░░░░░░░░░░░░░░░░░░░░░░░░░░░░░░░░░░░░░░░░░░░░░░░░░░░░░░░░░░░░░░░░░░░░░░░░░░░░░░░░░░░░░░░░░░░░░░░░░░░░░░░░░░░░░░░░░░░░░░░░░░░░░░░░░░░░░░░░░░░░░░░░░░░░░░░░░░░░░░░░░░░░░░░░░░░░░░░░░░░░             ░░░░░░░
░░░░░░░░░░░░░░░░░░░░░░░░░░░░░░░░░░░░░░░░░░░░░░░░░░░░░░░░░░░░░░░░░░░░░░░░░░░░░░░░░░░░░░░░░░░░░░░░░░░░░░░░░░░░░░░░░░░░░░░░░░░░░░░░░░░░░░░░░░░░░░░░░░░░░░░░░░░░░░░░░░░░░░░░░░░░░░░░░░░░             ░░░░░░░
░░░░░░░░░░░░░░░░░░░░░░░░░░░░░░░░░░░░░░░░░░░░░░░░░░░░░░░░░░░░░░░░░░░░░░░░░░░░░░░░░░░░░░░░░░░░░░░░░░░░░░░░░░░░░░░░░░░░░░░░░░░░░░░░░░░░░░░░░░░░░░░░░░░░░░░░░░░░░░░░░░░░░░░░░░░░░░░░░░░░             ░░░░░░░
░░░░░░░░░░░░░░░░░░░░░░░░░░░░░░░░░░░░░░░░░░░░░░░░░░░░░░░░░░░░░░░░░░░░░░░░░░░░░░░░░░░░░░░░░░░░░░░░░░░░░░░░░░░░░░░░░░░░░░░░░░░░░░░░░░░░░░░░░░░░░░░░░░░░░░░░░░░░░░░░░░░░░░░░░░░░░░░░░░░░             ░░░░░░░
░░░░░░░░░░░░░░░░░░░░░░░░░░░░░░░░░░░░░░░░░░░░░░░░░░░░░░░░░░░░░░░░░░░░░░░░░░░░░░░░░░░░░░░░░░░░░░░░░░░░░░░░░░░░░░░░░░░░░░░░░░░░░░░░░░░░░░░░░░░░░░░░░░░░░░░░░░░░░░░░░░░░░░░░░░░░░░░░░░░░             ░░░░░░░
░░░░░░░░░░░░░░░░░░░░░░░░░░░░░░░░░░░░░░░░░░░░░░░░░░░░░░░░░░░░░░░░░░░░░░░░░░░░░░░░░░░░░░░░░░░░░░░░░░░░░░░░░░░░░░░░░░░░░░░░░░░░░░░░░░░░░░░░░░░░░░░░░░░░░░░░░░░░░░░░░░░░░░░░░░░░░░░░░░░░       M     ░░░░░░░
░░░░░░░░░░░░░░░░░░░░░░░░░░░░░░░░░░░░░░░░░░░░░░░░░░░░░░░░░░░░░░░░░░░░░░░░░░░░░░░░░░░░░░░░░░░░░░░░░░░░░░░░░░░░░░░░░░░░░░░░░░░░░░░░░░░░░░░░░░░░░░░░░░░░░░░░░░░░░░░░░░░░░░░░░░░░░░░░░░░░             ░░░░░░░",
    "init_pos": [32,47],
    "exits": {
        "31,0" : ["Gazebo",[6,126]],
        "32,0" : ["Gazebo",[6,126]],
        "33,0" : ["Gazebo",[7,126]],
        "34,0" : ["Gazebo",[7,126]],
        "35,0" : ["Gazebo",[8,126]],
        "36,0" : ["Gazebo",[8,126]],
        "37,0" : ["Gazebo",[9,126]],
        "38,0" : ["Gazebo",[9,126]],
        "39,0" : ["Gazebo",[10,126]],
        "40,0" : ["Gazebo",[10,126]],

	    "0,43" : ["Hostels",[278,350]], 
	    "0,44" : ["Hostels",[278,353]], 
	    "0,45" : ["Hostels",[278,356]], 
	    "0,46" : ["Hostels",[278,359]], 
	    "0,47" : ["Hostels",[278,362]], 
	    "0,48" : ["Hostels",[278,365]], 
	    "0,49" : ["Hostels",[278,368]], 
	    "0,50" : ["Hostels",[278,371]], 
	    "0,51" : ["Hostels",[278,374]], 
	    "0,52" : ["Hostels",[278,377]], 
	    "0,53" : ["Hostels",[278,380]], 
	    "0,54" : ["Hostels",[278,383]], 

	    "83,187" :["Main_gate_picture",[0,0]],

        "46,199" :["Road",[0,65]],
        "47,199" :["Road",[0,65]],
        "48,199" :["Road",[1,65]],

	    "68,0" :["AB1 AB2",[107,196]],
	    "69,0" :["AB1 AB2",[107,196]],
	    "70,0" :["AB1 AB2",[107,196]],
	    "71,0" :["AB1 AB2",[107,196]],
	    "72,0" :["AB1 AB2",[107,196]],
	    "73,0" :["AB1 AB2",[108,196]],
	    "74,0" :["AB1 AB2",[108,196]],
	    "75,0" :["AB1 AB2",[108,196]],
	    "76,0" :["AB1 AB2",[108,196]],
	    "77,0" :["AB1 AB2",[108,196]]
	 },
    "items": {}
}