{
    "name": "Lumiere Studio",
    "raw": "▉▉▉▉▉▉▉▉▉▉▉▉▉▉▉▉▉░░░░░░░░░░░░░░▉▉▉▉▉▉▉▉▉▉▉▉▉▉▉▉▉▉▉    ▉▉▉▉▉▉▉▉▉▉▉▉▉▉▉▉
▉▉                 ░░░░░░░░░░░░░░             ▉▉    ▉▉            ▉▉
▉▉                     ░░░░░░░                  ▉▉    ▉▉            ▉▉
▉▉                      ░░░░░░░░░░              ▉▉    ▉▉            ▉▉
▉▉                 ░░░░░░░░░░░░░░░░░░░          ▉▉▉▉▉▉▉▉            ▉▉
▉▉               ░░░░░░▉▉▉▉▉▉░░░░░░░░░░░        ▉▉                 ▉▉
▉▉                ░░░░▉▉▉░░▉▉░░░░░░░░░░░░       ▉▉                  ▉▉
▉▉                 ░░░░░░░░░░░░░▉▉░░░░          ▉▉                 ▉▉
▉▉                    ░░░░░░░▉▉▉▉░              ▉▉▉▉▉▉▉▉▉▉▉▉▉▉▉▉▉▉▉▉▉▉
▉▉░░                    ░░░░░░                  ▉▉░░░░░░░░░░░░░░░░░░░░
▉▉░░░░                    ░▉               ░░░░░▉▉░░░░░░░░░░░░░░░░░░░░
▉▉░░░░░░                                    ░░░░▉▉░░░░░░░░░░░░░░░░░░░░
▉▉░░░░░░░░                                  ░░░░░░░░░░░░░░░░░░░░░░░░
▉▉▉▉░░▉▉▉▉▉▉▉▉▉▉▉▉▉▉         ▉▉▉▉▉▉▉▉▉▉▉▉▉▉▉░░░░▉▉░░░░░░░░░░░░░░░░░░░░
░░░░░░░░░▉▉▉▉▉▉▉▉▉             ▉▉▉▉▉▉▉▉▉░░░░░░░░░░░░░░░░░░░░░░░░░░░░░░
░░░░░░░░░░░░▉▉▉▉▉▉             ▉▉▉▉▉▉░░░░░░░░░░░▉▉░░░░░░░░░░░░░░░░░░░░
░░░░░░░░░░░░░▉▉▉▉▉             ▉▉▉▉▉░░░░░░░░░░░░▉▉░░░░░░░░░░░░░░░░░░░░
░░░░░░░░░░░░▉▉▉▉▉▉             ▉▉▉▉▉▉░░░░░░░░░░░▉▉░░░░░░░░░░░░░░░░░░░░
░░░░░░░░░▉▉▉▉▉▉▉▉▉             ▉▉▉▉▉▉▉▉▉░░░░░░░░░░░░░░░░░░░░░░░░░░░░░░
▉▉▉▉▉▉▉▉▉▉▉▉▉▉▉▉▉▉▉▉         ▉▉▉▉▉▉▉▉▉▉▉▉▉▉▉▉▉▉▉▉▉░░░░░░░░░░░░░░░░░░░░
▉▉▉▉▉▉▉▉▉▉▉▉▉▉▉▉▉▉▉▉▉▉▉↓↓↓▉▉▉▉▉▉▉▉▉▉▉▉▉▉▉▉▉▉▉▉▉▉▉▉░░░░░░░░░░░░░░░░░░░░",
    "init_pos": [10,5],
    "exits": {
        "20,23" : ["Hostels",[1,560]],
        "20,24" : ["Hostels",[1,561]],
        "20,25" : ["Hostels",[1,562]]
    },
    "items": {
        "Picture 1/6" : [2, 2],
        "Picture 2/6" : [3, 2],
        "Picture 3/6" : [4, 2],
        "Picture 4/6" : [5, 2],
        "Picture 5/6" : [6, 2],
        "Picture 6/6" : [7, 2],
        "DSLR" : [4, 62],
        "Dark Room" : [17, 24],
        "Light Switch" : [16, 12],
        "Lumiere Terminal" : [8, 46]
    },
    "items_on_startup" : ["Dark Room", "Light Switch"]
}
