{
    "name": "SC",
    "raw": "░░░░░░░░░░░░░░░░░░░░░░░░░░░░░░░░░░░░░░░░░░░░░░░░░░░░░░░░░░░░░░░░░░░░░░░░░░░░░░░░░░░░░░░░░░░░░░░░░░░░░░░░░░░░░░░░░░░░░░░░░░░░░░░░░░░░░░░░↑ ↑ ↑ ↑ ↑ ↑ ↑ ↑ ↑ ↑ ↑ ↑ ↑ ↑ ↑ ░░░░░░░░░░░░░░░░░░░░░░░░░░
░░░░░░░░░░░░░░░░░░░░░░░░░░░░░░░░░░░░░░░░░░░░░░░░░░░░░░░░░░░░░░▓▓▓▓▓▓▓▓▓▓▓▓▓▓▓▓▓▓▓▓░░░░░░░░░░░░░░░░░░░░░░░░░░░░░░░░░░░░░░░░░░░░░░░░░░░░░░                              ░░░░░░░░░░░░░░░░░░░░░░░░░░
░░░░░░░░░░░░░░░░░░░░░░░░░░░░░░░░░░░░░░░░▓▓▓▓▓▓▓▓▓▓▓▓▓▓▓▓▓▓▓▓▓▓▓▓▓▓▓▓▓▓▓▓▓▓▓▓▓▓▓▓▓▓░░░░░░░░░░░░░░░░░░░░░░░░░░░░░░░░░░░░░░░░░░░░░░░░░░░░░░                              ░░░░░░░░░░░░░░░░░░░░░░░░░░
░░░░░░░░░░░░░░░░░░░░░░░░░░░░░░░░░░░░░░░░▓▓▓▓▓▓▓▓▓▓▓▓▓▓▓▓▓▓▓▓▓▓▓▓▓▓▓▓▓▓▓▓▓▓▓▓▓▓▓▓▓▓░░░░░░░░░░░░░░░░░░░░░░░░░░░░░░░░░░░░░░░░░░░░░░░░░░░░░░                              ░░░░░░▟▟▟▟▟▟▟▟▟▟░░░░░░░░░░
░░░░░░░░░░░░░░░░░░░░░░░░░░░░░░░░░░░░░░░░▓▓▓▓▓▓▓▓▓▓▓▓▓▓▓▓▓▓▓▓▓▓▓▓▓▓▓▓▓▓▓▓▓▓▓▓▓▓▓▓▓▓                              ░░░░░░░░░░░░░░░░░░░░░░░░                              ░░░░░░▟▟▟▟▟▟▟▟▟▟░░░░░░░░░░
░░░░░░░░░░░░░░░░░░░░░░░░░░░░░░░░░░░░░░░░▓▓▓▓▓▓▓▓▓▓▓▓▓▓▓▓▓▓▓▓▓▓▓▓▓▓▓▓▓▓▓▓▓▓▓▓▓▓▓▓▓*                              ░░░░░░░░░░░░░░░░░░░░░░░░                              ░░░░░░▟▟▟▟▟▟▟▟▟▟░░░░░░░░░░
░░░░░░░░░░░░░░░░░░░░░░░░░░░░░░░░░░░░░░░░▓▓▓▓▓▓▓▓▓▓▓▓▓▓▓▓▓▓▓▓▓▓▓▓▓▓▓▓▓▓▓▓▓▓▓▓▓▓▓▓▓*                              ░░░░░░░░░░░░░░░░░░░░░░░░                              ░░░░░░▟▟▟▟▟▟▟▟▟▟░░░░░░░░░░
░░░░░░░░░░░░░░░░░░░░░░░░░░░░░░░░░░░░░░░░▓▓▓▓▓▓▓▓▓▓▓▓▓▓▓▓▓▓▓▓▓▓▓▓▓▓▓▓▓▓▓▓▓▓▓▓▓▓▓▓▓*                              ░░░░░░░░░░░░░░░░░░░░░░░░                              ░░░░░░▟▟▟▟▟▟▟▟▟▟░░░░░░░░░░
░░░░░░░░░░░░░░░░░░░░░░░░░░░░░░░░░░░░░░░░▓▓▓▓▓▓▓▓▓▓▓▓▓▓▓▓▓▓▓▓▓▓▓▓▓▓▓▓▓▓▓▓▓▓▓▓▓▓▓▓▓*                              ░░░░░░░░░░░░░░░░░░░░░░░░                              ░░░░░░░░░░░░░░░░░░░░░░░░░░
░░░░░░░░░░░░░░░░░░░░░░░░░░░░░░░░░░░░░░░░▓▓▓▓▓▓▓▓▓▓▓▓▓▓▓▓▓▓▓▓▓▓▓▓▓▓▓▓▓▓▓▓▓▓▓▓▓▓▓▓▓*                              ░░░░░░░░░░░░░░░░░░░░░░░░                              ░░░░░░░░░░░░░░░░░░░░░░░░░░
░░░░░░░░░░░░░░░░░░░░░░░░░░░░░░░░░░░░░░░░▓▓▓▓▓▓▓▓▓▓▓▓▓▓▓▓▓▓▓▓▓▓▓▓▓▓▓▓▓▓▓▓▓▓▓▓▓▓▓▓▓▓                              ░░░░░░░░░░░░░░░░░░░░░░░░                              ░░░░░░░░░░░░░░░░░░░░░░░░░░
░░░░░░░░░░░░░░░░░░░░░░░░░░░░░░░░░░░░░░░░▓▓▓▓▓▓▓▓▓▓▓▓▓▓▓▓▓▓▓▓▓▓▓▓▓▓▓▓▓▓▓▓▓▓▓▓▓▓▓▓▓▓                              ░░░░░░░░░░░░░░░░░░░░░░░░                              ░░░░░░░░░░░░░░░░░░░░░░░░░░
░░░░░░░░░░░░░░▉▉▉▉▉▉▉▉▉▉▉▉▉▉▉▉▉▉▉▉▉▉▉▉▉▉▉▉▉▉▉▉░░░░░░░░░░▓▓▓▓▓▓▓▓▓▓▓▓▓▓▓▓▓▓▓▓▓▓▓▓▓▓░░░░░░░░░░░░░░░░░░░░░░                                                              ░░░░░░░░░░░░░░░░░░░░░░░░░░
░░░░░░░░░░░░░░▉▉▉▉▉▉▉▉▉▉▉▉▉▉▉▉▉▉▉▉▉▉▉▉▉▉▉▉▉▉▉▉░░░░░░░░▓▓▓▓▓▓▓▓▓▓░░░░░░░░░░░░░░░░░░░░░░░░░░░░░░░░░░░░░░░░                                                              ░░░░░░░░░░░░░░░░░░░░░░░░░░
░░░░░░░░░░░░░░▉▉▉▉▉▉▉▉▉▉▉▉▉▉▉▉▉▉▉▉▉▉▉▉▉▉▉▉▉▉▉▉░░░░░░░░▓▓▓▓▓▓▓▓░░░░░░░░░░░░░░░░░░░░░░░░░░░░░░░░░░░░░░░░░░                                                              ░░░░░░░░░░░░░░░░░░░░░░░░░░
░░░░░░░░░░░░░░▉▉▉▉▉▉▉▉▉▉▉▉▉▉▉▉▉▉▉▉▉▉▉▉▉▉▉▉▉▉▉▉░░░░░░░░░░░░▓▓▓▓░░░░░░░░░░░░░░░░░░░░░░░░░░░░░░░░░░░░░░░░░░                                                              ░░░░░░░░░░░░░░░░░░░░░░░░░░
░░░░░░░░░░░░░░▉▉▉▉▉▉▉▉▉▉▉▉▉▉▉▉▉▉▉▉▉▉▉▉▉▉▉▉▉▉▉▉░░░░░░░░░░░░░░░░░░░░░░░░░░░░░░░░░░░░░░░░░░░░░░░░░░░░░░░░░░                                                              ░░░░░░░░░░░░░░░░░░░░░░░░░░
░░░░░░░░░░░░░░▉▉▉▉▉▉▉▉▉▉▉▉▉▉▉▉▉▉▉▉▉▉▉▉▉▉▉▉▉▉▉▉░░░░░░░░░░░░░░░░░░░░░░░░░░░░░░░░░░░░░░░░░░░░░░░░░░░░░░░░░░░░░░░░░░░░░░░░░░░░░░░░░░░░░░░░░░                              ░░░░░░░░▗▗▗▗▗▗░░░░░░░░░░░░
░░░░░░░░░░░░░░▉▉▉▉▉▉▉▉▉▉▉▉▉▉▉▉▉▉▉▉▉▉▉▉▉▉▉▉▉▉▉▉░░░░░░░░░░░░░░░░░░░░░░░░░░░░░░░░░░░░░░░░░░░░░░░░░░░░░░░░░░░░░░░░░░░░░░░░░░░░░░░░░░░░░░░░░░                              ░░░░░░▗▗▗▗▗▗▗▗▗▗░░░░░░░░░░
░░░░░░░░░░░░░░▉▉▉▉▉▉▉▉▉▉▉▉▉▉▉▉▉▉▉▉▉▉▉▉▉▉▉▉▉▉▉▉░░░░░░░░░░░░░░░░░░▗▗▗▗▗▗▗▗▗▗░░░░░░░░░░░░░░░░░░░░░░░░░░░░░░░░░░░░░░░░░░░░░░░░░░░░░░░░░░░░░░                              ░░░░▗▗▗▗▗▗▗▗▗▗▗▗▗▗░░░░░░░░
░░░░░░░░░░░░░░▉▉▉▉▉▉▉▉▉▉▉▉▉▉▉▉▉▉▉▉▉▉▉▉▉▉▉▉▉▉▉▉░░░░░░░░░░░░░░▗▗▗▗▗▗▗▗▗▗▗▗▗▗▗▗▗▗░░░░░░░░░░░░░░░░░░░░░░░░░░░░░░░░░░░░░░░░░░░░░░░░░░░░░░░░░░                              ░░░░▗▗▗▗▗▗▗▗▗▗▗▗▗▗░░░░░░░░
░░░░░░░░░░░░░░▉▉▉▉▉▉▉▉▉▉▉▉▉▉▉▉▉▉▉▉▉▉▉▉▉▉▉▉▉▉▉▉░░░░░░░░░░░░▗▗▗▗▗▗▗▗▗▗▗▗▗▗▗▗▗▗▗▗▗▗░░░░░░░░░░░░░░░░░░░░░░░░░░░░░░░░░░░░░░░░░░░░░░░░░░░░░░░░                              ░░░░▗▗▗▗▗▗▗▗▗▗▗▗▗▗░░░░░░░░
░░░░░░░░░░░░░░▉▉▉▉▉▉▉▉▉▉▉▉▉▉▉▉▉▉▉▉▉▉▉▉▉▉▉▉▉▉▉▉░░░░░░░░░░▗▗▗▗▗▗▗▗▗▗▗▗▗▗▗▗▗▗▗▗▗▗▗▗▗▗░░░░░░░░░░░░░░░░░░░░░░░░░░░░░░░░░░░░░░░░░░░░░░░░░░░░░░                              ░░░░░░▗▗▗▗▗▗▗▗▗▗░░░░░░░░░░
░░░░░░░░░░░░░░▉▉▉▉▉▉▉▉▉▉▉▉▉▉▉▉▉▉▉▉▉▉▉▉▉▉▉▉▉▉░░░░░░░░░░░░▗▗▗▗▗▗▗▗▗▗▗▗▗▗▗▗▗▗▗▗▗▗▗▗▗▗░░░░░░░░░░░░░░░░░░░░░░░░░░░░░░░░░░░░░░░░░░░░░░░░░░░░░░                              ░░░░░░░░▗▗▗▗▗▗░░░░░░░░░░░░
░░░░░░░░░░░░░░▉▉▉▉▉▉▉▉▉▉▉▉▉▉▉▉▉▉▉▉▉▉▉▉▉▉▉▉▉▉░░░░░░░░░░▗▗▗▗▗▗▗▗▗▗▗▗▗▗▗▗▗▗▗▗▗▗▗▗▗▗▗▗▗▗░░░░░░░░░░░░░░░░░░░░░░░░░░░░░░░░░░░░░░░░░░░░░░░░░░░░                              ░░░░░░░░░░░░░░░░░░░░░░░░░░
░░░░░░░░░░░░░░▉▉▉▉▉▉▉▉▉▉▉▉▉▉▉▉▉▉▉▉▉▉▉▉▉▉▉▉▉▉░░░░░░░░░░▗▗▗▗▗▗▗▗▗▗▗▗▗▗▗▗▗▗▗▗▗▗▗▗▗▗▗▗▗▗░░░░░░░░░░░░░░░░░░░░░░░░░░░░░░░░░░░░░░░░░░░░░░░░░░░░                              ░░░░░░░░░░░░░░░░░░░░░░░░░░
░░░░░░░░░░░░░░▉▉▉▉▉▉▉▉▉▉▉▉▉▉▉▉▉▉▉▉▉▉▉▉▉▉▉▉▉▉░░░░░░░░░░▗▗▗▗▗▗▗▗▗▗▗▗▗▗▗▗▗▗▗▗▗▗▗▗▗▗▗▗▗▗░░░░░░░░░░░░░░░░░░░░░░░░░░░░░░░░░░░░░░░░░░░░░░░░░░░░                              ░░░░░░░░░░░░░░░░░░░░░░░░░░
░░░░░░░░░░░░░░▉▉▉▉▉▉▉▉▉▉▉▉▉▉▉▉▉▉▉▉▉▉▉▉▉▉▉▉▉▉░░░░░░░░░░▗▗▗▗▗▗▗▗▗▗▗▗▗▗▗▗▗▗▗▗▗▗▗▗▗▗▗▗▗▗░░░░░░░░░░░░░░░░░░░░░░░░░░░░░░░░░░░░░░░░░░░░░░░░░░░░                              ░░░░░░░░░░░░░░░░░░░░░░░░░░
░░░░░░░░░░░░░░▉▉▉▉▉▉▉▉▉▉▉▉▉▉▉▉▉▉▉▉▉▉▉▉▉▉▉▉▉▉░░░░░░░░░░▗▗▗▗▗▗▗▗▗▗▗▗▗▗▗▗▗▗▗▗▗▗▗▗▗▗▗▗▗▗░░░░░░░░░░░░░░░░░░░░░░░░░░░░░░░░░░░░░░░░░░░░░░░░░░░░                              ░░░░░░░░░░░░░░░░░░░░░░░░░░
░░░░░░░░░░░░░░▉▉▉▉▉▉▉▉▉▉▉▉▉▉▉▉▉▉▉▉▉▉▉▉▉▉▉▉▉▉░░░░░░░░░░░░▗▗▗▗▗▗▗▗▗▗▗▗▗▗▗▗▗▗▗▗▗▗▗▗▗▗░░░░░░░░░░░░░░░░░░░░░░░░░░░░░░░░░░░░░░░░░░░░░░░░░░░░░░                              ░░░░░░░░░░░░░░░░░░░░░░░░░░
░░░░░░░░░░░░░░▉▉▉▉▉▉▉▉▉▉▉▉▉▉▉▉▉▉▉▉▉▉▉▉▉▉▉▉▉▉░░░░░░░░░░░░▗▗▗▗▗▗▗▗▗▗▗▗▗▗▗▗▗▗▗▗▗▗▗▗▗▗░░░░░░░░░░░░░░░░░░░░░░░░░░▗▗▗▗▗▗▗▗░░░░░░░░░░░░░░░░░░░░                              ░░░░░░░░░░░░░░░░░░░░░░░░░░
░░░░░░░░░░░░░░▉▉▉▉▉▉▉▉▉▉▉▉▉▉▉▉▉▉▉▉▉▉▉▉▉▉▉▉▉▉░░░░░░░░░░░░░░▗▗▗▗▗▗▗▗▗▗▗▗▗▗▗▗▗▗▗▗▗▗░░░░░░░░░░░░░░░░░░░░░░░░░░▗▗▗▗▗▗▗▗▗▗▗▗░░░░░░░░░░░░░░░░░░                              ░░░░░░░░░░░░░░░░░░░░░░░░░░
░░░░░░░░░░░░░░▉▉▉▉▉▉▉▉▉▉▉▉▉▉▉▉▉▉▉▉▉▉▉▉▉▉▉▉▉▉░░░░░░░░░░░░░░░░▗▗▗▗▗▗▗▗▗▗▗▗▗▗▗▗▗▗░░░░░░░░░░░░░░░░░░░░░░░░░░▗▗▗▗▗▗▗▗▗▗▗▗▗▗▗▗░░░░░░░░░░░░░░░░                              ░░░░░░░░░░░░░░░░░░░░░░░░░░
░░░░░░░░░░░░░░▉▉▉▉▉▉▉▉▉▉▉▉▉▉▉▉▉▉▉▉▉▉▉▉▉▉▉▉▉▉░░░░░░░░░░░░░░░░░░░░▗▗▗▗▗▗▗▗▗▗░░░░░░░░░░░░░░░░░░░░░░░░░░░░▗▗▗▗▗▗▗▗▗▗▗▗▗▗▗▗▗▗▗▗░░░░░░░░░░░░░░                              ░░░░░░▟▟▟▟▟▟▟▟▟▟░░░░░░░░░░
░░░░░░░░░░░░░░▉▉▉▉▉▉▉▉▉▉▉▉▉▉▉▉▉▉▉▉▉▉▉▉▉▉▉▉▉▉░░░░░░░░░░░░░░░░░░░░░░░░░░░░░░░░░░░░░░░░░░░░░░░░░░░░░░░░░░▗▗▗▗▗▗▗▗▗▗▗▗▗▗▗▗▗▗▗▗░░░░░░░░░░░░░░                              ░░░░░░▟▟▟▟▟▟▟▟▟▟░░░░░░░░░░
░░░░░░░░░░░░░░▉▉▉▉▉▉▉▉▉▉▉▉▉▉▉▉▉▉▉▉▉▉▉▉▉▉▉▉▉▉░░░░░░░░░░░░░░░░░░░░░░░░░░░░░░░░░░░░░░░░░░░░░░░░░░░░░░░░░░▗▗▗▗▗▗▗▗▗▗▗▗▗▗▗▗▗▗▗▗░░░░░░░░░░░░░░                              ░░░░░░▟▟▟▟▟▟▟▟▟▟░░░░░░░░░░
░░░░░░░░░░░░░░▉▉▉▉▉▉▉▉▉▉▉▉▉▉▉▉▉▉▉▉▉▉▉▉▉▉▉▉▉▉░░░░░░░░░░░░░░░░░░░░░░░░░░░░░░░░░░░░░░░░░░░░░░░░░░░░░░░░░░▗▗▗▗▗▗▗▗▗▗▗▗▗▗▗▗▗▗▗▗░░░░░░░░░░░░░░                              ░░░░░░▟▟▟▟▟▟▟▟▟▟░░░░░░░░░░
░░░░░░░░░░░░░░▉▉▉▉▉▉▉▉▉▉▉▉▉▉▉▉▉▉▉▉▉▉▉▉▉▉▉▉▉▉░░░░░░░░░░░░░░░░░░░░░░░░░░░░░░░░░░░░░░░░░░░░░░░░░░░░░░░░░░░░▗▗▗▗▗▗▗▗▗▗▗▗▗▗▗▗░░░░░░░░░░░░░░░░                              ░░░░░░▟▟▟▟▟▟▟▟▟▟░░░░░░░░░░
░░░░░░░░░░░░░░▉▉▉▉▉▉▉▉▉▉▉▉▉▉▉▉▉▉▉▉▉▉▉▉▉▉▉▉▉▉░░░░░░░░░░░░░░░░░░░░░░░░░░░░░░░░░░░░░░░░░░░░░░░░░░░░░░░░░░░░░░▗▗▗▗▗▗▗▗▗▗▗▗░░░░░░░░░░░░░░░░░░                              ░░░░░░░░░░░░░░░░░░░░░░░░░░
░░░░░░░░░░░░░░▉▉▉▉▉▉▉▉▉▉▉▉▉▉▉▉▉▉▉▉▉▉▉▉▉▉▉▉▉▉░░░░░░░░░░░░░░░░░░░░░░░░░░░░░░░░░░░░░░░░░░░░░░░░░░░░░░░░░░░░░░░░▗▗▗▗▗▗▗▗░░░░░░░░░░░░░░░░░░░░                              ░░░░░░░░░░░░░░░░░░░░░░░░░░
░░░░░░░░░░░░░░▉▉▉▉▉▉▉▉▉▉▉▉▉▉▉▉▉▉▉▉▉▉▉▉▉▉▉▉▉▉░░░░░░░░░░░░░░░░░░░░░░░░░░░░░░░░░░░░░░░░░░░░░░░░░░░░░░░░░░░░░░░░░░░░░░░░░░░░░░░░░░░░░░░░░░░░                              ░░░░░░░░░░░░░░░░░░░░░░░░░░
░░░░░░░░░░░░░░▉▉▉▉▉▉▉▉▉▉▉▉▉▉▉▉▉▉▉▉▉▉▉▉▉▉▉▉▉▉░░░░░░░░░░░░░░░░░░░░░░░░░░░░░░░░░░░░░░░░░░░░░░░░░░░░░░░░░░░░░░░░░░░░░░░░░░░░░░░░░░░░░░░░░░░░                              ░░░░░░░░░░░░░░░░░░░░░░░░░░
░░░░░░░░░░░░░░▉▉▉▉▉▉▉▉▉▉▉▉▉▉▉▉▉▉▉▉▉▉▉▉▉▉▉▉▉▉░░░░░░░░░░░░░░░░░░░░░░░░░░░░░░░░░░░░░░░░░░░░░░░░░░░░░░░░░░░░░░░░░░░░░░░░░░░░░░░░░░░░░░░░░░░░                              ░░░░░░░░░░░░░░░░░░░░░░░░░░
░░░░░░░░░░░░░░▉▉▉▉▉▉▉▉▉▉▉▉▉▉▉▉▉▉▉▉▉▉▉▉▉▉▉▉▉▉░░░░░░░░░░░░░░░░░░░░░░░░░░░░░░░░░░░░░░░░░░░░░░░░░░░░░░░░░░░░░░░░░░░░░░░░░░░░░░░░░░░░░░░░░░░░                              ░░░░░░░░░░░░░░░░░░░░░░░░░░
░░░░░░░░░░░░░░▉▉▉▉▉▉▉▉▉▉▉▉▉▉▉▉▉▉▉▉▉▉▉▉▉▉▉▉▉▉░░░░░░░░░░░░░░░░░░░░░░░░░░░░░░░░░░░░░░░░░░░░░░░░░░░░░░░░░░░░░░░░░░░░░░░░░░░░░░░░░░░░░░░░░░░░                              ░░░░░░░░░░░░░░░░░░░░░░░░░░
░░░░░░░░░░░░░░▉▉▉▉▉▉▉▉▉▉▉▉▉▉▉▉▉▉▉▉▉▉▉▉▉▉▉▉▉▉░░░░░░░░░░░░░░░░░░░░░░░░░░░░░░░░░░░░░░░░░░░░░░░░░░░░░░░░░░░░░░░░░░░░░░░░░░░░░░░░░░░░░░░░░░░░                              ░░░░░░░░░░░░░░░░░░░░░░░░░░
░░░░░░░░░░░░░░▉▉▉▉▉▉▉▉▉▉▉▉▉▉▉▉▉▉▉▉▉▉▉▉▉▉▉▉▉▉░░░░░░░░░▃▃▃▃▃▃▃▃▃▃▃▃▃▃▃▃▃▃▃▃▃▃▃▃▃░░░░░░░░░░░░░░░░░░░░░░░░░░░░░░░░░░░░░░░░░░░░░░░░░░░░░░░░░░                              ░░░░░░░░░░░░░░░░░░░░░░░░░░
░░░░░░░░░░░░░░▉▉▉▉▉▉▉▉▉▉▉▉▉▉▉▉▉▉▉▉▉▉▉▉▉▉▉▉▉▉▃▃▃▃▃▃▃▃▃▌                       ▐▃▃▃▃▃▃▃▃                                                                                ░░░░░░░░▗▗▗▗▗▗░░░░░░░░░░░░
░░░░░░░░░░░░░░▉▉▉▉▉▉▉▉▉▉▉▉▉▉▉▉▉▉▉▉▉▉▉▉▉▉▉▉▉▉▃▃******▃▃▃▃▃▃▃▃▃▃↓ ↓↓ ↓▃▃▃▃▃▃▃▃▃▃******▃▃                                                                                ░░░░░░▗▗▗▗▗▗▗▗▗▗░░░░░░░░░░
░░░░░░░░░░░░░░▉▉▉▉▉▉▉▉▉▉▉▉▉▉▉▉▉▉▉▉▉▉▉▉▉▉▉▉▉▉▉▉▉▉▉▉▉▉▉▉▉▉▉▉▉▉▉▉▉▉▉▉▉▉▉▉▉▉▉▉▉▉▉▉▉▉▉▉▉▉▉▉                                                                                ░░░░▗▗▗▗▗▗▗▗▗▗▗▗▗▗░░░░░░░░
░░░░░░░░░░░░░░▉▉▉▉▉▉▉▉▉▉▉▉▉▉▉▉▉▉▉▉▉▉▉▉▉▉▉▉▉▉▉▉▉▉▉▉▉▉▉▉▉▉▉▉▉▉▉▉▉▉▉▉▉▉▉▉▉▉▉▉▉▉▉▉▉▉▉▉▉▉▉▉                                                                                ░░░░▗▗▗▗▗▗▗▗▗▗▗▗▗▗░░░░░░░░
░░░░░░░░░░░░░░▉▉▉▉▉▉▉▉▉▉▉▉▉▉▉▉▉▉▉▉▉▉▉▉▉▉▉▉▉▉▉▉▉▉▉▉▉▉▉▉▉▉▉▉▉▉▉▉▉▉▉▉▉▉▉▉▉▉▉▉▉▉▉▉▉▉▉▉▉▉▉▉                                                                                ░░░░▗▗▗▗▗▗▗▗▗▗▗▗▗▗░░░░░░░░
░░░░░░░░░░░░░░▉▉▉▉▉▉▉▉▉▉▉▉▉▉▉▉▉▉▉▉▉▉▉▉▉▉▉▉▉▉▉▉▉▉▉▉▉▉▉▉▉▉▉▉▉▉▉▉▉▉▉▉▉▉▉▉▉▉▉▉▉▉▉▉▉▉▉▉▉▉▉▉░░░░░░░░░░░░░░░░░░░░░░░░░░░░░░░░░░░░░░░░░░░░░░░░░░                              ░░░░░░▗▗▗▗▗▗▗▗▗▗░░░░░░░░░░
░░░░░░░░░░░░░░▉▉▉▉▉▉▉▉▉▉▉▉▉▉▉▉▉▉▉▉▉▉▉▉▉▉▉▉▉▉▉▉▉▉▉▉▉▉▉▉▉▉▉▉▉▉▉▉▉▉▉▉▉▉▉▉▉▉▉▉▉▉▉▉▉▉▉▉▉▉▉▉░░░░░░░░░░░░░░░░░░░░░░░░░░░░░░░░░░░░░░░░░░░░░░░░░░                              ░░░░░░░░▗▗▗▗▗▗░░░░░░░░░░░░
░░░░░░░░░░░░░░▉▉▉▉▉▉▉▉▉▉▉▉▉▉▉▉▉▉▉▉▉▉▉▉▉▉▉▉▉▉▉▉▉▉▉▉▉▉▉▉▉▉▉▉▉▉▉▉▉▉▉▉▉▉▉▉▉▉▉▉▉▉▉▉▉▉▉▉▉▉▉▉░░░░░░░░░░░░░░░░░░░░░░░░░░░░░░░░░░░░░░░░░░░░░░░░░░                              ░░░░░░░░░░░░░░░░░░░░░░░░░░
░░░░░░░░░░░░░░▉▉▉▉▉▉▉▉▉▉▉▉▉▉▉▉▉▉▉▉▉▉▉▉▉▉▉▉▉▉▉▉▉▉▉▉▉▉▉▉▉▉▉▉▉▉▉▉▉▉▉▉▉▉▉▉▉▉▉▉▉▉▉▉▉▉▉▉▉▉▉▉░░░░░░░░░░░░░░░░░░░░░░░░░░░░░░░░░░░░░░░░░░░░░░░░░░                              ░░░░░░░░░░░░░░░░░░░░░░░░░░
░░░░░░░░░░░░░░▉▉▉▉▉▉▉▉▉▉▉▉▉▉▉▉▉▉▉▉▉▉▉▉▉▉▉▉▉▉▉▉▉▉▉▉▉▉▉▉▉▉▉▉▉▉▉▉▉▉▉▉▉▉▉▉▉▉▉▉▉▉▉▉▉▉▉▉▉▉▉▉░░░░░░░░░░░░░░░░░░░░░░░░░░░░░░░░░░░░░░░░░░░░░░░░░░                              ░░░░░░░░░░░░░░░░░░░░░░░░░░
░░░░░░░░░░░░░░▉▉▉▉▉▉▉▉▉▉▉▉▉▉▉▉▉▉▉▉▉▉▉▉▉▉▉▉▉▉▉▉▉▉▉▉▉▉▉▉▉▉▉▉▉▉▉▉▉▉▉▉▉▉▉▉▉▉▉▉▉▉▉▉▉▉▉▉▉▉▉▉░░░░░░░░░░░░░░░░░░░░░░░░░░░░░░░░░░░░░░░░░░░░░░░░░░                              ░░░░░░░░░░░░░░░░░░░░░░░░░░
░░░░░░░░░░░░░░▉▉▉▉▉▉▉▉▉▉▉▉▉▉▉▉▉▉▉▉▉▉▉▉▉▉▉▉▉▉▉▉▉▉▉▉▉▉▉▉▉▉▉▉▉▉▉▉▉▉▉▉▉▉▉▉▉▉▉▉▉▉▉▉▉▉▉▉▉▉▉▉░░░░░░░░░░░░░░░░░░░░░░░░░░░░░░░░░░░░░░░░░░░░░░░░░░                              ░░░░░░░░░░░░░░░░░░░░░░░░░░
░░░░░░░░░░░░░░▉▉▉▉▉▉▉▉▉▉▉▉▉▉▉▉▉▉▉▉▉▉▉▉▉▉▉▉▉▉▉▉▉▉▉▉▉▉▉▉▉▉▉▉▉▉▉▉▉▉▉▉▉▉▉▉▉▉▉▉▉▉▉▉▉▉▉▉▉▉▉▉░░░░░░░░░░░░░░░░░░░░░░░░░░░░░░░░░░░░░░░░░░░░░░░░░░                              ░░░░░░░░░░░░░░░░░░░░░░░░░░
░░░░░░░░░░░░░░▉▉▉▉▉▉▉▉▉▉▉▉▉▉▉▉▉▉▉▉▉▉▉▉▉▉▉▉▉▉▉▉▉▉▉▉▉▉▉▉▉▉▉▉▉▉▉▉▉▉▉▉▉▉▉▉▉▉▉▉▉▉▉▉▉▉▉▉▉▉▉▉░░░░░░░░░░░░░░░░░░░░░░░░░░░░░░░░░░░░░░░░░░░░░░░░░░                              ░░░░░░░░░░░░░░░░░░░░░░░░░░
░░░░░░░░░░░░░░░░░░░░░░░░░░░░░░░░░░░░░░░░░░░░░░░░░░░░░░░░░░░░░░░░░░░░░░░░░░░░░░░░░░░░░░░░░░░░░░░░░░░░░░░░░░░░░░░░░░░░░░░░░░░░░░░░░░░░░░░░                              ░░░░░░░░░░░░░░░░░░░░░░░░░░
░░░░░░░░░░░░░░░░░░░░░░░░░░░░░░░░░░░░░░░░░░░░░░░░░░░░░░░░░░░░░░░░░░░░░░░░░░░░░░░░░░░░░░░░░░░░░░░░░░░░░░░░░░░░░░░░░░░░░░░░░░░░░░░░░░░░░░░░                              ░░░░░░░░░░░░░░░░░░░░░░░░░░
░░░░░░░░░░░░░░░░░░░░░░░░░░░░░░░░░░░░░░░░░░░░░░░░░░░░░░░░░░░░░░░░░░░░░░░░░░░░░░░░░░░░░░░░░░░░░░░░░░░░░░░░░░░░░░░░░░░░░░░░░░░░░░░░░░░░░░░░↓ ↓ ↓ ↓ ↓ ↓ ↓ ↓ ↓ ↓ ↓ ↓ ↓ ↓ ↓ ░░░░░░▟▟▟▟▟▟▟▟▟▟░░░░░░░░░░",
    "init_pos": [60,151],
    "exits": {
		"63,136" : ["Hostels",[1,772]],
		"63,137" : ["Hostels",[1,773]],
		"63,138" : ["Hostels",[1,774]],
		"63,139" : ["Hostels",[1,775]],
		"63,140" : ["Hostels",[1,776]],
		"63,141" : ["Hostels",[1,777]],
		"63,142" : ["Hostels",[1,778]],
		"63,143" : ["Hostels",[1,779]],
		"63,144" : ["Hostels",[1,780]],
		"63,145" : ["Hostels",[1,781]],
		"63,146" : ["Hostels",[1,782]],
		"63,147" : ["Hostels",[1,783]],
		"63,148" : ["Hostels",[1,784]],
		"63,149" : ["Hostels",[1,785]],
		"63,150" : ["Hostels",[1,786]],
		"63,151" : ["Hostels",[1,787]],
		"63,152" : ["Hostels",[1,788]],
		"63,153" : ["Hostels",[1,789]],
		"63,154" : ["Hostels",[1,790]],
		"63,155" : ["Hostels",[1,791]],
		"63,156" : ["Hostels",[1,792]],
		"63,157" : ["Hostels",[1,793]],
		"63,158" : ["Hostels",[1,794]],
		"63,160" : ["Hostels",[1,795]],
		"63,160" : ["Hostels",[1,796]],
		"63,161" : ["Hostels",[1,797]],
		"63,162" : ["Hostels",[1,798]],
		"63,163" : ["Hostels",[1,799]],
		"63,164" : ["Hostels",[1,800]],
		"63,165" : ["Hostels",[1,801]],

		"0,136" : ["Community Centre",[60,156]],
		"0,137" : ["Community Centre",[60,157]],
		"0,138" : ["Community Centre",[60,158]],
		"0,139" : ["Community Centre",[60,159]],
		"0,140" : ["Community Centre",[60,160]],
		"0,141" : ["Community Centre",[60,161]],
		"0,142" : ["Community Centre",[60,162]],
		"0,143" : ["Community Centre",[60,163]],
		"0,144" : ["Community Centre",[60,164]],
		"0,145" : ["Community Centre",[60,165]],
		"0,146" : ["Community Centre",[60,166]],
		"0,147" : ["Community Centre",[60,167]],
		"0,148" : ["Community Centre",[60,168]],
		"0,149" : ["Community Centre",[60,169]],
		"0,150" : ["Community Centre",[60,170]],
		"0,151" : ["Community Centre",[60,171]],
		"0,152" : ["Community Centre",[60,172]],
		"0,153" : ["Community Centre",[60,173]],
		"0,154" : ["Community Centre",[60,174]],
		"0,155" : ["Community Centre",[60,175]],
		"0,156" : ["Community Centre",[60,176]],
		"0,157" : ["Community Centre",[60,177]],
		"0,158" : ["Community Centre",[60,178]],
		"0,160" : ["Community Centre",[60,179]],
		"0,160" : ["Community Centre",[60,180]],
		"0,161" : ["Community Centre",[60,181]],
		"0,162" : ["Community Centre",[60,182]],
		"0,164" : ["Community Centre",[60,183]],
		"0,165" : ["Community Centre",[60,184]],

		"48,62" : ["Lata Mukherjee's Shop",[1,32]],
		"48,63" : ["Lata Mukherjee's Shop",[1,36]],
		"48,64" : ["Lata Mukherjee's Shop",[1,40]],
		"48,65" : ["Lata Mukherjee's Shop",[1,40]],
		"48,66" : ["Lata Mukherjee's Shop",[1,44]],
		"48,67" : ["Lata Mukherjee's Shop",[1,48]]
},
    "items": {
		"Light Blue Bottle": [52, 122],
		"Boars": [59, 166],
		"Marvelous Dbs": [46, 166],
		"Chai Chem": [41, 66],
		"Doggo Picture": [37, 99],
		"Fact3": [43, 166],
		"Fact4": [17, 135]
	}
}
